游戏;玩偶;玩偶;手指伸进去表演的木偶，套在手指上表演的手套木偶;	轻工业、手工业;工艺美术制品工业;民间工艺美术制品;木偶制作;	建筑科学;建筑设计;工业建筑;构筑物;塔形、柱形等构筑物;烟囱;
运动;游戏;娱乐活动;体育锻炼;球类;训练器械;实芯球;弹子;	科学、教育、体育;体育;文体活动;康乐球、台球、弹子;	地质、矿产普查与勘探;钻探工程;钻具及工具;钻进工具;
农业;林业;畜牧业;狩猎;收获;割草;捆扎收获或割下产品的设备;打捆机;	农业科学;畜牧、狩猎;畜牧业的机具及设备;干草及青贮饲料收获机;干草捆草机、压捆机;	无线电电子学、电信技术;传输线和波导;波导、波导管、波导传输线;
医学;卫生学;化合物或药物制剂的特定治疗活性;治疗神经系统疾病的药物;抗偏头痛药;	医药、卫生;神经病学与精神病学;神经病学;植物性神经系疾病;偏头痛;	电气化、电能应用;电气照明;各种用途的灯;矿灯;
食品或食料;乳制品，如干酪;奶或干酪的代用品;干酪;干酪配制品;	轻工业、手工业;食品工业;乳品加工工业;各种乳制品;干酪;	电气化、电能应用;电气照明;灯泡、灯管;白热灯泡、白炽灯;
救生;消防;背包型灭火器;	市政工程及公用设备;消防;消防设备;灭火装置;	武器工业;水中兵器;鱼雷及其发射装置;鱼雷发射装置;
办公家具;绘图桌或台;绘图板的支架;	文教用品制造工业;绘图工具;绘图板、绘图桌;	力学;流体力学;普通流体力学;流体动力学;
家庭用具或餐桌用具;餐具;	玩具制造工业;餐具、炊具、浴具;	农业工程;农业机械及农具;收获机械;分段收获机;割捆机;
体育锻炼;平衡木;	体育;体操运动;竞技体操;平衡木;	武器工业;爆破器材、火炸药;爆破器材;扫雷器材;
农业或林业的整地;专门用途的犁或类似的机具;用于耕整两层或多层土壤的;	农业科学;农业工程;农业机械及农具;耕耘机具;犁;	电工技术;电气化、电能应用;电气照明;灯泡、灯管;气体放电灯;
运动;体育锻炼;球类;高尔夫球棍;球棍头;	体育;球类运动;高尔夫球;	汽车工程;汽车用燃料、润滑料;液化可燃气燃料;液化石油气;
家庭用的物品或设备;镜子;画框或类似物;做设备用的镜;	轻工业、手工业;制镜;镜子;	电工技术;电器;电阻器、电位器;固定电阻器;
食品或食料;以产品为特征的食料成型或加工;使用添加剂;	食品工业;食品原料及添加剂;食品添加剂;	无线电电子学、电信技术;电视;电视信号的传输;电视信号的红外线传输系统;
狩猎;诱捕;动物的捕捉、诱捕或惊吓;狩猎设备;	农业科学;狩猎;狩猎方法、设备及用具;	水利工程;水利工程基础科学;水力学;水工模型;水工模型试验;正态模型;
农业或林业的整地;专门适用于长有作物的土地整地的其他专用机械;除草用的;	农业工程;农业机械及农具;田间管理机械;中耕除草、培土机械;除草机;	工业技术;化学工业;合成树脂与塑料工业;聚合类树脂及塑料;聚烯烃类及塑料;
烟草;吸烟者用品;吸雪茄烟或纸烟的器具;切断烟烬的用具;	轻工业、手工业;烟草工业;烟草工业副产品加工与利用;	冶金工业;炼铁;高炉操作;开炉、配料;开炉、装料;
手携物品或旅行品;旅行或野营装备和用品;野餐用具;	轻工业、手工业;体育器具制造工业;军事体育器具;野营器具;	自动化技术;计算技术、计算机技术;电子数字计算机;外部设备;外存储器;
家庭的洗涤或清扫;清扫地板、地毯、家具、墙壁或墙壁覆盖物的用具;冲刷;抛光;布;垫;海绵;	化学工业;橡胶工业;胶乳制品;海绵类;	农业科学;农业基础科学;肥料学;施肥机具;
农业或林业的整地;专门适用于长有作物的土地整地的其他专用机械;专用的;作垄的;	农学（农艺学）;耕作学与有机农业;一般耕作技术;整地;	医药、卫生;临床医学;治疗学;物理疗法、自然疗法;电疗法、磁疗法;
农业;林业;畜牧业;农业或林业的整地;装有固定式犁铧的犁;拖拉机悬挂犁;	农业工程;农业机械及农具;耕耘机具;犁;机力犁;铧式犁;	化学工业;磁性记录材料工业;原材料及辅助物料;载体;
农业;林业;畜牧业;农业或林业的整地;装有固定式犁铧的犁;畜力牵引犁;	农业工程;农业机械及农具;耕耘机具;犁;机力犁;铧式犁;	工业技术;武器工业;水中兵器;水雷;探雷、扫雷设备;
运动;游戏;娱乐活动;玩具，如陀螺、玩偶、滚铁环、积木;玩偶;零件;附属物;	其他轻工业、手工业;玩具制造工业;各种玩具：按用途分;玩偶的服饰、用具;	铸造;铸造机械设备;熔炼设备;反射炉;
卫生学;医用、牙科用或梳妆用的配制品;以特殊物理形状为特征的医药配制品;丸剂、锭剂或片剂;	医药、卫生;药学;药剂学;剂型;固体制剂;锭剂;	能源与动力工程;蒸汽动力工程;蒸汽锅炉;锅炉构造;燃烧装置;
卫生学;医用、牙科用或梳妆用的配制品;以特殊物理形状为特征的医药配制品;丸剂、锭剂或片剂;	医药、卫生;药学;药剂学;剂型;片剂;	农业科学;农学（农艺学）;农产品收获;收获;
家具;家庭用的物品或设备;厨房用具;烘;烤;煎;炸;烘烤专用的容器;	电气化、电能应用;家用电器及其他电器设备;厨房用电器、电炊具;电烤箱;	测绘学;摄影测量学与测绘遥感;非地形摄影测量;近影摄影测量;
医学;卫生学;绷带;绷带;石膏绷带;其他硬化绷带;	医药、卫生;外科学;外科手术学;绷带学;	工业技术;轻工业、手工业;纺织工业、染整工业;染整工业;印花;印花方法;
家具;家庭用的物品或设备;门和窗的装饰品;窗帘绳索的辅助用具;操纵窗帘绳索的啮合器;	建筑科学;建筑材料;有机材料、建筑化工材料;建筑塑料及其制品;建筑塑料制品;门、窗等塑料配件和零件;	电工技术;电机;发电机、大型发电机组（总论）;
卫生学;材料或消毒的一般方法或装置;空气的消毒、灭菌或除臭;应用物理现象;辐照;紫外线辐照;	医药、卫生;预防医学、卫生学;流行病学与防疫;消毒;光线消毒、紫外线消毒;	汽车工程;汽车发动机;往复式发动机;各种类型往复式发动机;气体燃料发动机;
屠宰;肉品处理;肉类、家禽或鱼的加工;加工肉类的车间、工厂或类似设施;	食品工业;屠宰及肉类加工工业;肉类食品加工厂、屠宰场;	铁路运输;铁路线路工程;线路构造;轨道;轨道结构、轨道设计;
农业;林业;畜牧业;收获;割草;耧耙;带可调式耧齿梁的;	农业科学;林业;森林工程、林业机械;营林作业机械与设备;抚育机械;割草、割灌机具;	建筑科学;房屋建筑设备;排水设备;下水道的通气系统;
通过在物质中产生化学变化使有害化学物质无害或降低危害的方法;通过与化学试剂反应;通过水解;	工业技术;化学工业;纤维素质的化学加工工业;植物纤维水解工业;三废处理与综合利用;	电工材料;导电材料及其制品;电气装备用电线电缆;通用电线电缆;
医学或兽医学;卫生学;医用、牙科用或梳妆用的配制品;含有机有效成分的医药配制品;	医药、卫生;药学;药物基础科学;药物化学;有机药物化学;	轻工业、手工业;服装工业、制鞋工业;制鞋工业;结构、部件及配件;鞋底、内底;
农业;林业;畜牧业;收获;割草;挖掘机，例如马铃薯挖掘犁;	农业工程;农业机械及农具;耕耘机具;农田基本建设机具;挖掘机;	水利工程;水利工程施工;各种工程、工种;隧洞与地下工程;钻爆法施工;衬砌;
农业;林业;通过组织培养技术的植物再生;裸子作物，例如针叶树;	生物科学;植物学;植物形态学;植物生态形态学;植物再生作用;	金属材料;有色金属、稀有金属及其合金材料;铜及铜合金;
农业;林业;施肥;专门适用于液体厩肥或其他液体肥料;施用液肥的浇水系统;	农业科学;园艺;设施园艺（保护地栽培）;温室;温室管理;浇水;	化学工业;化学纤维工业;无机纤维;玻璃纤维;
农业;林业;农业或林业的整地;利用工作部件和土壤之间电压差的整地;	农业科学;农学（农艺学）;耕作学与有机农业;一般耕作技术;整地;	轻工业、手工业;造纸工业;机械与设备;造纸机械;长网造纸机;
农业;林业;农业或林业的整地;利用工作部件和土壤之间电压差的整地;	农业科学;林业;造林学、林木育种及造林技术;造林技术;整地;	工业技术;武器工业;火炮;加农炮;
鞋类;制鞋或修鞋的机械、工具、设备或方法;固定在鞋底部的鞋底或鞋跟;	轻工业、手工业;服装工业、制鞋工业;制鞋工业;结构、部件及配件;鞋跟;	公路运输;汽车工程;电气设备及附件;照明与信号系统;停刹车信号装置;
鞋类;制鞋或修鞋的机械、工具、设备或方法;固定在鞋底部的鞋底或鞋跟;	轻工业、手工业;服装工业、制鞋工业;制鞋工业;结构、部件及配件;鞋底、内底;	机械、仪表工业;机械零件及传动装置;转动机件;轴承;滚动轴承;滚柱轴承;
医学或兽医学;卫生学;兽医用仪器、器械、工具或方法;兽医用绷带、泥敷剂、敷布;	动物医学;动物医学（兽医学）;家畜卫生及防疫;兽医卫生保健组织;兽医器材及药品管理;	纺织工业;针织;针织工艺;经编工艺;
农业;畜牧业;鱼类;装活鱼的容器，例如水族槽;专门适用于运输活鱼的容器;	农业科学;水产、渔业;水产物运输;水产生物运输;鱼类的运输及设备;活鱼;	电工技术;发电、发电厂;配电设备和电气接线;开关设备;
农业;林业;化学化合物或制剂的杀生;除草剂;杀藻剂;	农业科学;植物保护;农药防治（化学防治）;各种农药;除草剂（杀草剂）;	化学工业;橡胶工业;胶乳;合成胶乳;其他胶乳;
农业;林业;化学化合物或制剂的杀生;除草剂;杀藻剂;	工业技术;化学工业;农药工业;除草剂;无机除草剂;	冶金工业;有色金属冶炼;金属提炼;火法提炼;热还原法;铝热法;
农业;畜牧业;狩猎;诱捕;捕鱼;捕鱼;捕鱼用抄网;捕鱼用捞网;	农业科学;水产、渔业;水产捕捞;捕捞技术;网鱼法;抄网、掩网捕捞;	化学工业;染料及中间体工业;各种性能的合成染料;碱性染料;
农业;畜牧业;狩猎;诱捕;捕鱼;捕鱼;捕鱼用抄网;捕鱼用捞网;	农业科学;水产、渔业;水产捕捞;渔具与捕鱼设备;渔网具;抄网、掩网;	地球科学;测绘学;地图制图学（地图学）;地图模型、地球仪;
珠宝;其他人身装饰品;勋章;徽章;	工艺美术;中国工艺美术;金属工艺美术;徽章;	公路运输;道路工程;道路养护与维修;机动养路机械与设备;洒水车;
医学;卫生学;诊断;外科;外科器械、装置或方法;	医药、卫生;外科学;外科诊疗器械与用具;	机械、仪表工业;机械零件及传动装置;转动机件;轴承;滑动轴承;塑料滑动轴承;
屠宰;肉品处理;家禽或鱼的加工;屠宰;屠宰厂设备;	食品工业;屠宰及肉类加工工业;屠宰加工机械与设备;	化学工业;磁性记录材料工业;原材料及辅助物料;载体;
医学;卫生学;电疗;磁疗;放射疗;超声波疗;电疗法;其所用的线路;	医药、卫生;临床医学;治疗学;物理疗法、自然疗法;电疗法、磁疗法;	纺织工业;针织;针织工艺;经编工艺;
农业;收获;割草;农产品的收获方法;	农业科学;农学（农艺学）;农产品收获;收获;	机械、仪表工业;起重机械与运输机械;起重机械;各种用途起重机(含缆索起重机);
服装;人造花;假发;羽饰;假发;	毛发、羽毛加工及制品;假发、假须、假睫毛;	轻工业、手工业;纺织工业、染整工业;染整工业;印花;印花方法;
服装;人造花;假发;羽饰;假发;	生活服务技术;美容;理发;假发;	电工技术;电机;发电机、大型发电机组;永磁发电机;
农业;林业;种植;施肥;带离心轮的施肥机;	农业机械及农具;田间管理机械;肥料机械;肥料施肥机具;	地质、矿产普查与勘探;钻探工程;钻具及工具;钻进工具;
农业;林业;种植;施肥;带离心轮的施肥机;	农业科学;农业基础科学;肥料学;施肥机具;	农业工程;农业机械及农具;耕耘机具;农田基本建设机具;挖掘机;
农业;林业;种植;施肥;带离心轮的施肥机;	农业工程;农业机械及农具;田间管理机械;肥料机械;施肥机;	机械、仪表工业;机械零件及传动装置;液压传动;传动装置;动力式液压传动;
农业;林业;种植;播种;施肥;带离心轮的播种机;	农业工程;农业机械及农具;种植机械;播种机;特殊结构播种机;	电信技术;通信;数据通信;各种数据传输系统;数字数据传输系统;
游戏;娱乐活动;玩具;交通玩具;模型铁路;	玩具制造工业;各种玩具：按造型分;交通工具;	金属学与金属工艺;金属切削加工及机床;拉削加工与拉床;
食品;它们的制备或处理;水产食物制品;鱼肉或鱼粉;	食品工业;水产加工工业;水产制品;鱼粉、鱼翅;	工业技术;化学工业;炼焦化学工业;煤的高温干馏;炼焦;炼焦炉;
鞋类;制鞋的机械、工具、设备;有供鞋运输器的制鞋机;	轻工业、手工业;制鞋工业;制鞋工业;制鞋机具与设备;其他;	文教用品制造工业;簿册、活页印制;卡片;
农业;园艺;果树、葡萄;葡萄、果树的栽培;	农业科学;园艺;果树园艺;浆果类;葡萄;	无线电电子学;基本电子电路;滤波技术、滤波器;谐振体;
运动;体育锻炼、体操;训练器械;爬竿、爬架或爬梯;	体育;体育;体操运动;运动辅助体操;旋梯（爬绳）、爬竿;	自动化技术;计算技术、计算机技术;程序设计、软件工程;软件工程;
新植物或获得新植物的方法;特征在于其植物学分类的被子植物;伞形花科;	植物学;植物分类学（系统植物学）;被子植物亚门;伞形花目;伞形科;	科学、教育、体育;体育;文体活动;康乐球、台球、弹子;
新植物或获得新植物的方法;特征在于其植物学分类的被子植物;天南星科;	植物学;植物分类学（系统植物学）;被子植物亚门;天南星科;	电信技术;基本电子电路;数字电路;逻辑电路;
新植物或获得新植物的方法;特征在于其植物学分类的被子植物;十字花科;	植物学;植物分类学（系统植物学）;被子植物亚门;十字花科;	化学工业;硅酸盐工业;玻璃工业;生产机械制造;
新植物或获得新植物的方法;特征在于其植物学分类的被子植物;龙胆科;	植物学;植物分类学（系统植物学）;被子植物亚门;龙胆科;	无线电电子学;电子元件、组件;移相器、铁氧体移相器;
服装;人造花;假发;面具;面具或掩藏整身的蒙面具;假面具;	轻工业、手工业;工艺美术制品工业;民间工艺美术制品;假面具、脸谱;	植物学;植物分类学（系统植物学）;被子植物亚门;伞形花目;伞形科;
人类生活必需品;农业;诱捕;捕鱼;鱼类;捕鱼;钓鱼竿;	农业科学;水产、渔业;水产捕捞;渔具与捕鱼设备;钓鱼具;	无线电电子学、电信技术;电子元件、组件;微波传输控制元件;波导定向耦合器;
烟草;雪茄烟;纸烟;吸烟者用品;雪茄烟或纸烟的烟嘴;雪茄烟;纸烟;	工业技术;轻工业、手工业;烟草工业;烟草加工工艺及制品;雪茄烟;	机械、仪表工业;仪器、仪表;天文仪器;天象仪;
医学或兽医学;卫生学;电疗;磁疗;放射疗;超声波疗;磁疗法;	医药、卫生;临床医学;治疗学;物理疗法、自然疗法;电疗法、磁疗法;	金属学与金属工艺;金属切削加工及机床;拉削加工与拉床;
运动;体育锻炼;球类;高尔夫球杆,高尔夫球球棒;	文化、科学、教育、体育;球类运动;高尔夫球;	农业科学;畜牧;普通畜牧学;畜牧业的机具及设备;饲料收获加工机械;干草及青贮饲料收获机;割草机;
农业;畜牧业;狩猎;收获;割草;收割机或割草机的附件;保护人或牲畜的装置;	农业科学;畜牧;普通畜牧学;畜牧业的机具及设备;饲料收获加工机械;干草及青贮饲料收获机;割草机;	交通运输;水路运输;船舶工程;航海技术管理与救助打捞;打捞工程;沉船打捞;
农业;林业;收获;割草;收割机或割草机的附件;固定在收割机或割草机上的刃磨设备;	农业科学;林业;森林工程、林业机械;营林作业机械与设备;抚育机械;割草、割灌机具;	电工技术;电气化、电能应用;电气照明;照明器;指示灯;
农业;林业;畜牧业;狩猎;收获;割草;割捆机;	农业工程;农业机械及农具;收获机械;分段收获机;割捆机;	化学工业;染料及中间体工业;各种结构的合成染料;靛系染料;
农业;林业;农业或林业的整地;一般农业机械或农具的部件、零件或附件;镇压器;	农业科学;农业工程;农业机械及农具;耕耘机具;表土耕作机械;镇压器;	原子能技术;各种核反应堆、核电厂;核电厂（核电站）;
捕鱼;鱼类;饲养或养殖其他类不包含的动物;鱼类等的养殖;鱼的;	农业科学;水产、渔业;水产养殖技术;各种鱼类养殖;淡水鱼;青鱼;	一般工业技术;摄影技术;摄影机具与设备;照相设备与复制设备;照相机;
农业;林业;畜牧业;收获;割草;花生收获机;	农业机械及农具;收获机械;块根作物收获机;花生、油莎豆收获机;	轻工业、手工业;五金制品工业;五金制品;日用五金制品;炉灶及灶具;
家庭用的物品或设备;未列入其他类目的卫生设备;盥洗室辅助用具;浴缸;淋浴器;	建筑科学;房屋建筑设备;房屋卫生技术设备;卫生设备;浴室及其设备;	真空电子技术;气体放电器件、离子管;脉冲放电管;火花放电管;
烟草;纸烟;吸烟或嚼烟的制造或制备;烟草;烟叶除梗;弄弯、切丝、烘丝;	轻工业、手工业;烟草工业;烟草加工工艺及制品;卷烟制造;切丝、烘丝;	金属学与金属工艺;金属学与热处理;热处理;有色金属及其合金的热处理;镁及其合金的热处理;
烟草;吸烟或嚼烟的制造或制备;烟草;烟叶除梗;抽梗;通过拔出烟梗;	轻工业、手工业;烟草工业;烟草加工工艺及制品;卷烟制造;抽梗、压梗;	合成树脂与塑料工业;机械与设备;制品加工成型设备;
其他类不包含的食品或食料;专门适用于生产动物饲料原料的保存方法;	畜牧;普通畜牧学;饲料;饲料加工处理与贮藏、保存方法;	化学工业;高分子化合物工业（高聚物工业）;生产过程;改性处理;交联法;
农业;林业;畜牧业;乳制品的加工;黄油或类似物的揉制机;	食品工业;乳品加工工业;乳品加工工艺;乳制品加工;	农业科学;农业基础科学;肥料学;农家肥料;堆肥、沤肥;
游戏;供公共娱乐用的类似装置;旋转游艺机;	玩具制造工业;各种玩具：按用途分;游艺性玩具;	电工技术;电气化、电能应用;家用电器及其他电器设备;其他电器;家用报警器;
鞋类;鞋类的特征;鞋类的部件;插入的内底，如鞋垫或嵌体;	服装工业、制鞋工业;制鞋工业;结构、部件及配件;鞋底、内底;	冶金工业;炼钢;平炉炼钢;平炉操作技术;开炉装料;
运动;游戏;体育锻炼、爬山的器械;训练器械;登山运动用的器械;	其他轻工业、手工业;体育器具制造工业;其他体育器具;登山运动器具;	电信技术;通信;电报中继及交换;中继器;
服装;衣饰配件;衣服的零件或其制作;修饰品;装饰物;	服装工业;服装工业;各种服装制品;各种服装：装饰用品分;	武器、军用器材;海军武器;水中武器;深水炸弹;
体育锻炼、体操或击剑用的器械;击剑用的;	教育、体育;体育;其他体育运动;击剑;	航空、航天;航空;飞机构造与设计;座舱;座舱盖;
农业;一般农业机械或农具的部件、零件或附件;犁;畜力牵引犁;	农业科学;农业工程;农业机械及农具;耕耘机具;犁;畜力犁;	畜牧;普通畜牧学;饲料;饲料加工处理与贮藏、保存方法;
鞋类;鞋类的特征;鞋类的部件;鞋跟;	制鞋工业;制鞋工业;结构、部件及配件;鞋跟;	铁路运输;铁路运输管理工程;铁路枢纽;进站线路疏解、进路交叉;交叉;
乳制品，奶;奶或干酪的代用品;奶配制品;奶粉或奶粉的配制品;	轻工业、手工业;食品工业;乳品加工工业;各种乳制品;奶粉;	电工技术;电机;电机制造工艺及设备;一般制造工艺;
运动;体育锻炼;球类;穿弦网球;	教育、体育;体育;球类运动;网球;	电气化、电能应用;家用电器及其他电器设备;厨房用电器、电炊具;电烤箱;
运动;体育锻炼;球类;穿弦网球;	体育器具制造工业;球类运动器具;网球、球网及附件;	无线电电子学;无线电导航;导航设备、导航台;导航计算机;
医学;卫生学;治疗免疫或过敏性疾病的药物;	医药、卫生;基础医学;医学免疫学;免疫药理学;	轻工业、手工业;纺织工业、染整工业;非织造布;各类非织造布;针刺法非织造布;
医学;卫生学;治疗免疫或过敏性疾病的药物;	医药、卫生;药学;药理学;免疫药理学;	纺织工业、染整工业;毛纺织;原毛初加工;羊毛脂回收;
农业;种植;播种;施肥;厩肥处理;施厩肥;厩肥装载机;	农业工程;农业机械及农具;肥料机械;厩肥、堆肥装载机，施肥机;	化学工业;试剂与纯化学品的生产;离子交换剂;离子交换剂的使用方法;电解法;
烟草;雪茄烟;纸烟;制造雪茄烟的部件;	烟草工业;烟草加工工艺及制品;雪茄烟;	农业工程;农业机械及农具;田间管理机械;中耕除草、培土机械;除草机;
农业;畜牧业;狩猎;畜牧业;畜牧业用的其他设备;	农业科学;畜牧;普通畜牧学;畜牧业的机具及设备;	公路运输;汽车工程;汽车结构部件;行走系统;车轮;轮辋;组合式;
食品或食料;咖啡;咖啡;咖啡代用品;	农业科学;农作物;饮料作物;咖啡;	农业机械及农具;收获机械;块根作物收获机;花生、油莎豆收获机;
农业;林业;畜牧业;脱粒;脱粒设备;	农业机械及农具;脱粒机具;简易脱粒机具;	机械、仪表工业;机械零件及传动装置;转动机件;联轴器、离合器;
农业;种植;施肥;施肥机工作部件的驱动装置;	农业科学;农业基础科学;肥料学;施肥机具;	电信技术;通信;通信保密与通信安全;保密通信:按传输线路分;无线保密通信;
农业;林业;种植;施肥;施肥机工作部件的驱动装置;	农业工程;农业机械及农具;田间管理机械;肥料机械;施肥机;	机械、仪表工业;起重机械与运输机械;运输机械;输送机辅助设备;抛料机;
农业;林业;种植;播种;播种机工作部件的驱动装置;	农业工程;农业机械及农具;种植机械;播种机;特殊结构播种机;	工业技术;电工技术;电器;继电器;电继电器;电磁继电器;
机床;金属加工;车削;镗削;镗、钻床组;镗床;卧式镗铣组合机床;	金属学与金属工艺;金属切削加工及机床;镗削加工及镗床;卧式镗床;	矿业工程;矿山安全与劳动保护;矿井通风;通风系统、通风方法与设备;
基本上无切削的金属机械加工;金属冲压;冲压金属;折缘或其他边缘处理，如管的;管端反向装缘;	金属学与金属工艺;金属压力加工;冷冲压（钣金加工）;冷冲压工艺;各种型材的冷冲压工艺;管材冲压;	金属学与金属工艺;铸造;铸造机械设备;铸件落砂和清理设备;去除浇口、冒口;
作业;运输;无轨陆用车辆;专门适用于这些交通工具的传动装置;以使用非机械传动，例如液力传动为特点的传动装置;	机械、仪表工业;机械零件及传动装置;液压传动;传动装置;动力式液压传动;	建筑科学;建筑施工机械和设备;混凝土机械与设备;混凝土及砂浆搅拌机、搅拌车;混凝土搅拌机;
一般的物理或化学的方法或装置;化学或物理方法，例如，催化作用或胶体化学;其有关设备;制备催化剂之一般方法;混合;	化学工业;试剂与纯化学品的生产;催化剂（触媒）;催化剂制备工艺;催化剂成型方法;	航空发动机;发动机附件系统;起动系统;原理;电动起动;
塑料的加工;一般处于塑性状态物质的加工;涉及成型材料或涉及用于增强材料、填料或预型件;用聚烯烃增强;	工业技术;化学工业;合成树脂与塑料工业;聚合类树脂及塑料;聚烯烃类及塑料;	纺织工业;毛纺织;原毛初加工;烘干;
印刷;排版机;制版、排字或拆版还字用的机器或附件;照相或光电排字装置;光电排字机;	轻工业、手工业;印刷工业;一般性问题;机械与设备;排版设备;	能源与动力工程;蒸汽动力工程;蒸汽锅炉;锅炉构造;水处理及给水装置;
其他类目中不包括的金属加工;钎焊或脱焊;焊接;用钎焊或焊接方法包覆或镀敷;关于钎焊或焊接的;	工业技术;金属学与金属工艺;焊接、金属切割及金属粘接;焊接工艺;钎焊;	化学工业;一般性问题;化学反应过程;一般化学反应过程;卤化、卤化剂;
塑料的加工;一般处于塑性状态物质的加工;用未特别指定的高分子化合物作为模制材料;热固性树脂;	工业技术;化学工业;合成树脂与塑料工业;合成树脂及塑料;合成树脂;热固性树脂;	造纸工业;产品;各种加工纸;涂布加工纸;
飞行器;航空;宇宙航行;用于与飞机配合或装到飞机上的设备;其他类目不包含的应急设备或装置;弹射或离机装置;弹射座椅;	航空、航天;航空;航空仪表、航空设备、飞行控制与导航;防护、救生设备及其技术;救生设备;应急离机设备;弹射座椅;	建筑科学;建筑施工机械和设备;混凝土机械与设备;混凝土及砂浆搅拌机、搅拌车;砂浆搅拌机;
基本上无切削的金属机械加工;金属冲压;金属板或管、棒的加工或处理;配置于压力机上或与压力机有关的特殊拉深装置;	工业技术;金属学与金属工艺;金属压力加工;锻造、锻压与锻工;锻造用机械与设备;曲柄压力机;模锻曲柄压力机;	金属学与金属工艺;金属表面处理;金属表面防护技术;金属复层保护;电镀法;
飞行器;航空;宇宙航行;飞机;直升飞机;旋翼机;其特有的旋翼;直升飞机;	航空、航天;航空;各类型航空器;短距和垂直升降航空器;直升飞机、旋翼机;	建筑科学;建筑材料;建筑化工材料;建筑塑料制品;塑料屋面材料;
塑料的加工;一般处于塑性状态物质的加工;涉及成型材料或涉及用于增强材料、填料或预型件;硼;	化学工业;合成树脂与塑料工业;增强塑料、填充塑料;硼纤维增强塑料;	交通运输;铁路运输;车辆工程;货车;罐车;
一般的物理或化学的方法或装置;化学或物理方法;离子交换剂的再生或再活化;其设备;电再生;	化学工业;试剂与纯化学品的生产;离子交换剂;离子交换剂的使用方法;电解法;	轻工业、手工业;制鞋工业;制鞋工业;制鞋机具与设备;其他;
塑料的加工;一般处于塑性状态物质的加工;用纤维素、改性纤维素或纤维素衍生物增强，如黏胶;	化学工业;合成树脂与塑料工业;天然高分子树脂与塑料;改性天然树脂与塑料;纤维素脂及塑料;	公路运输;汽车工程;汽车结构部件;仪表;指示信号灯;
机床;其他类目中不包括的金属加工;焊接;局部加热切割，如火焰切割;气体火焰焊接;用于非接合目的，如堆焊;	工业技术;金属学与金属工艺;焊接、金属切割及金属粘接;焊接工艺;堆焊及补焊;	音乐;器乐理论与演奏法;键盘、簧乐理论和演奏法;手风琴;
印刷;印刷机械或印刷机;平压平印刷机;用于平版印刷;	轻工业、手工业;印刷工业;平版印刷;印刷过程与设备;	工业技术;金属压力加工;锻造用机械与设备;摩擦压力机;
无轨陆用车辆;畜拉车;车的类型;客车;	交通运输;铁路运输;车辆工程;客车;	公路运输;桥涵工程;各种桥梁;桥梁：按结构分;悬索桥;
运输;一般车辆;调节车轮制动力的装置;调节过程中控制参数的确定，例如通过对测量或检测的参数的计算;	交通运输;公路运输;汽车工程;整车设计与计算;整车性能计算;制动性计算;	电工技术;电器;电容器;电容器:按结构分;卷式电容器;
一般车辆;一般车辆的电力制动系统;与动态电能量回收式制动联用的动态电阻制动;	交通运输;铁路运输;机车工程;机车构造;制动装置;电控制动及装置;	工业技术;轻工业、手工业;其他轻工业、手工业;乐器制造工业;电乐器;电振荡乐器;
一般车辆;一般车辆的电力制动系统;与动态电能量回收式制动联用的动态电阻制动;	交通运输;公路运输;汽车工程;汽车结构部件;制动系统;制动操纵装置;电力式;	玩具制造工业;各种玩具：按造型分;交通工具;
包装;贮存;用于物件或物料贮存或运输的容器;麻袋、袋或类似容器;以使用的材料为特点的;用织物制作的;	轻工业、手工业;纺织工业、染整工业;麻纺织;麻织工艺;麻袋缝制;	武器工业;水中兵器;深水炸弹及发射装置;火箭式发射装置;
装订;图册;文件夹;特种印刷品;没有另作规定的特殊格式或风格的印刷品;报纸或类似的物品;	轻工业、手工业;印刷工业;印刷技术的应用;报纸印刷;	化学工业;非金属元素及其无机化合物化学工业;硼及其无机化合物;硼;
磨削;抛光;用于磨削或抛光的机床、装置或工艺;磨削，抛光剂或研磨剂的进给;磨削机床或装置的驱动或传动装置;及其设备;	金属学与金属工艺;金属切削加工及机床;磨削加工与磨床;磨床设计、制造与维修;结构;液压传动系统及装置;	医药、卫生;神经病学与精神病学;神经病学;植物性神经系疾病;偏头痛;
磨削;抛光;用于磨削或抛光的机床、装置或工艺;磨削机床或装置的部件，比如机架，床身;工件支架;	金属学与金属工艺;金属切削加工及机床;磨削加工与磨床;磨床设计、制造与维修;结构;机械结构;	机械、仪表工业;机械零件及传动装置;转动机件;轴承;滚动轴承;滚柱轴承;
卷扬;提升;牵引;升降机;自动扶梯或移动人行道;自动扶梯或移动人行道的零部件;扶手栏杆;	机械、仪表工业;起重机械与运输机械;自动扶梯;	一般性问题;化工机械与仪器、设备;化工用炉灶、化工窑;炉窑附属设备;
金属机械加工;金属冲压;金属的轧制;金属轧制的方法或制造实心半成品或成型截面的轧机;轧制特殊截面形状的工件，如角钢;	金属学与金属工艺;金属压力加工;轧制;轧制工艺;型材轧制;角钢轧制;	工业技术;轻工业、手工业;造纸工业;造纸工艺;纸品加工工艺;层压加工、复合加工;
加工水泥、黏土或石料;制造水泥与其他材料混合物的设备或方法，例如与泥浆，砂浆;专门适用于装在车上用于在运输时搅拌的装置;	建筑科学;建筑施工机械和设备;混凝土机械与设备;混凝土及砂浆搅拌机、搅拌车;砂浆搅拌机;	航空、航天;航空;飞机构造与设计;起落装置;起落架减震器;
加工水泥、黏土或石料;制造水泥与其他材料混合物的设备或方法，例如与泥浆，砂浆;专门适用于装在车上用于在运输时搅拌的装置;	建筑科学;建筑施工机械和设备;混凝土机械与设备;混凝土及砂浆搅拌机、搅拌车;混凝土搅拌机;	轻工业、手工业;印刷工业;一般性问题;机械与设备;排版设备;
一般车辆;适用于货运或运输、装载或包容特殊货物或物体的车辆;用于载运搅拌好的混凝土，例如具有转鼓的;	建筑科学;建筑施工机械和设备;混凝土机械与设备;混凝土及砂浆搅拌机、搅拌车;	化学工业;金属元素的无机化合物化学工业;铍的无机化合物;
运输;提升;升降机;矿井提升机卷扬装置的主要部件;	工业技术;矿业工程;矿山运输与设备;矿井提升;提升机;	物理学;原子核物理学;中子物理;中子截面;吸收截面;
装订;图册;书;书籍封皮;书或其他装订成册的制品;图册;	自然科学参考工具书;表解、图解、谱录、数据、公式、图册;	化学工业;金属元素的无机化合物;铬副族;钼的无机化合物;
金属加工;螺纹切制;螺钉、螺栓头或螺母的加工;螺纹切制刀具;铣刀;	金属学与金属工艺;刀具、磨料、磨具、夹具、模具和手工具;刀具;铣刀;	真空技术;真空获得技术及设备;真空泵;机械真空泵;离心真空泵;
运输;输送;运输装置，装载或倾卸用输送机;物件或固体物料机械抛料机;	机械、仪表工业;起重机械与运输机械;运输机械;输送机辅助设备;抛料机;	交通运输;铁路运输;铁路线路工程;线路构造;轨枕;
运输;铁路;专门适用于铁路车辆的牵引装置或缓冲装置;牵引装置;	交通运输;铁路运输;机车工程;内燃机车;牵引电机及电器;牵引电器;	交通运输;铁路运输;机车工程;电力机车;保护装置;过负荷保护;
运输;无轨陆用车辆;机动车;挂车;以流线型为特点的车身;	交通运输;公路运输;汽车工程;各种汽车;挂车;挂车;	无线电电子学、电信技术;基本电子电路;放大技术、放大器;放大器;
运输;车辆动力装置或传动装置;车辆辅助驱动装置;辅助驱动装置;	能源与动力工程;内燃机;汽油机;构造;传动装置(驱动装置);	化学工业;硅酸盐工业;玻璃工业;各种玻璃产品;玻璃纤维;
作业;一般的物理或化学的方法或装置;分离;蒸气的冷凝;	化学工业;一般性问题;化工过程（物理过程及物理化学过程）;蒸汽的冷凝;	纺织工业、染整工业;针织;针织用机具;准备机械;
提升;自动扶梯;在楼房或其他建筑物内的，或与之配合的电梯;	工业技术;建筑科学;房屋建筑设备;机电设备;电梯工程;	生活服务技术;家务管理;家庭缝纫、织补;
运输;提升;升降机;在楼房或其他建筑物内的，或与之配合的电梯的种类和形式;升降机;	机械、仪表工业;起重机械与运输机械;起重机械;简易起重机械;升降机、升降台;	给水工程;取水工程;水源;水源勘测;
机床;金属加工;铣削;特殊工件的铣削;特殊铣削加工;其所用机床;	金属学与金属工艺;金属切削加工及机床;削加工及铣床;工具铣床;	化学工业;化学纤维工业;合成纤维;特种纤维;碳纤维系纤维;
运输;铁路;铁路车辆;用于运载液体材料的罐车;	交通运输;铁路运输;车辆工程;货车;罐车;	原子能技术;各种核反应堆;裂变、聚变混合反应堆;
压力机;一般压力机;使用旋转压力构件如辊、环、盘为特征的压力机;	工业技术;金属压力加工;锻造用机械与设备;摩擦压力机;	汽车工程;汽车结构部件;电气设备及附件;照明与信号系统;停刹车信号装置;
对表面涂布的装置;专门用于对表面涂布微粒物质的装置;	化学工业;感光材料工业;机械与设备;涂布机械与设备;	玩具制造工业;各种玩具：按用途分;游艺性玩具;
一般的物理或化学的方法或装置;化学或物理方法;一般的离子交换方法;其中涉及到了离子交换剂的吸附性能;	化学;物理化学（理论化学）、化学物理学;表面现象的物理化学;吸附;吸附理论;离子交换吸附作用;离子交换剂;	交通运输;水路运输;船舶工程;船舶机械;船舶辅机及设备;空气压缩机、空调设备;
一般的物理或化学的方法或装置;化学或物理方法;一般的离子交换方法;床工艺;混合床方法;	化学工业;试剂与纯化学品的生产;离子交换剂;离子交换剂的使用方法;分批操作法（混床法）;	化学工业;金属元素的无机化合物化学工业;第Ⅱ族金属元素的无机化合物;镁的无机化合物;
洗选颗粒状、粉末状或块状物料;沉—浮分离机械分选机;	工业技术;矿业工程;矿山机械;选矿机械;浮选机;	其他轻工业、手工业;乐器制造工业;西乐器;弓弦乐器;
用液体或用风力摇床或风力跳汰机分离固体物料;湿法分离;	冶金工业;有色金属冶炼;一般性问题;金属提炼;湿法冶炼;分离;	纺织工业、染整工业;毛纺织;原毛初加工;羊毛脂回收;
运输;无轨陆用车辆;交通工具的传动装置;用手或脚操作的曲柄结构;	公路运输;汽车工程;汽车结构部件;转向系统;转向器;曲柄传动式;	文教用品制造工业;绘图工具;绘图板、绘图桌;
机床;其他类目中不包括的金属加工;齿轮或齿条的制造;加工齿轮的专用方法或机床;	金属学与金属工艺;金属切削加工及机床;齿轮加工及齿轮机床;齿轮其他加工机床;	化学纤维工业;一般性问题;生产工艺;纺丝原液制备;
飞行器;航空;用于与飞机配合或装到飞机上的设备;动力装置短舱、整流装置或整流罩;	航空、航天;航空;飞机构造与设计;机身、座舱;座舱盖、整流片、整流罩;	交通运输;铁路运输;机车工程;蒸汽机车;蒸汽机部分;
飞行器;航空;动力装置在飞机中的配置或安装;动力装置短舱、整流装置或整流罩;	航空、航天;航空;飞机构造与设计;动力装置;发动机整流罩、螺旋桨帽、桨轴;	航空;航空发动机;发动机附件系统;冷却系统;空气喷气发动机冷却系统;
装订;特种印刷品;永久性装订;单张纸、纸叠或帖码的永久性装订;	轻工业、手工业;印刷工业;装订技术、装帧技术;装订过程与设备;	农业工程;农业机械及农具;种植机械;播种机;特殊结构播种机;
运输;铁路;用于铁路的其他辅助设备;润湿或润滑轨道或轮缘;	铁路运输;铁路线路工程;线路构造;钢轨;钢轨润滑、钢轨喷油器;	工业技术;武器工业;火炮;加农炮;
运输;铁路;用于铁路的其他辅助设备;润湿或润滑轨道或轮缘;	铁路运输;机车工程;内燃机车;辅助装置;润滑系统;润滑油、泵;	农业工程;农业机械及农具;田间管理机械;肥料机械;施肥机;
金属机械加工;金属冲压;锻造;锤击;压制;锻压机;	金属压力加工;锻造、锻压;锻造用机械与设备;自由锻水压机;	能源与动力工程;蒸汽动力工程;蒸汽锅炉;锅炉构造;燃烧装置;
飞行器;航空;宇宙航行;飞机;稳定面;水平尾翼;	航空、航天;航空;航空器结构力学;结构分析与计算;尾翼;	音乐;器乐理论与演奏法;打击乐理论和演奏法;小鼓、大鼓;
航空;飞机;直升飞机;稳定面;安装在机翼上或靠机翼支承的;	航空、航天;航空;飞机构造与设计;机翼;翼上辅助装置;	电信技术;电子元件、组件;电声器件;传声器;电容式传声器;
金属机械加工;金属冲压;冲压金属;用冲压、旋压或拉深的无切削成型;拉深;	金属学与金属工艺;金属压力加工;冷冲压（钣金加工）;深冲、拉延成型、拉深;	轻工业、手工业;工艺美术制品工业;民间工艺美术制品;假面具、脸谱;
一般的物理或化学的方法或装置;分离;液体的分离;不互溶的液体的分离;	化工过程（物理过程及物理化学过程）;分离过程;单相系液态混合物的分离过程;	医药、卫生;药学;药物基础科学;药物化学;有机药物化学;
机械手;机械手;装有操纵装置的容器;程序控制机械手;	自动化技术及设备;机器人技术;机械手;专用机械手;	一般工业技术;摄影技术;摄影机具与设备;照相设备与复制设备;照相机;
运输;铁路;铁路车辆的种类;有轨电车;	公路运输;其他道路运输工具;电车;有轨电车;	纺织工业、染整工业;一般性问题;纺织纤维（纺织原材料）;废纤维的回收与利用;
书写或绘图器具;办公用品;非活动铅笔;铅笔;彩色铅笔;	其他轻工业、手工业;文教用品制造工业;笔;铅笔;	轻工业、手工业;纺织工业、染整工业;非织造布;各类非织造布;针刺法非织造布;
金属加工;焊接;被钎焊、焊接或切割的材料;有色金属;铜或铜合金;	金属学与金属工艺;焊接、金属切割;焊接工艺;金属材料的焊接;钢;	化学工业;化学纤维工业;再生纤维;硝酸纤维素纤维;
金属加工;焊接;被钎焊、焊接或切割的材料;铁和黑色合金;铸铁合金;	金属学与金属工艺;焊接、金属切割;焊接工艺;;金属材料的焊接;铸铁;	航空、航天;航空;飞机构造与设计;机翼;翼上辅助装置;
金属加工;焊接;被钎焊、焊接或切割的材料;有色金属;铝或铝合金;	金属学与金属工艺;焊接、金属切割;焊接工艺;金属材料的焊接;铝;	力学;流体力学;物理-化学流体动力学;界面和毛细流动;
印刷;印刷机械或印刷机;凸版轮转印刷机;	印刷工业;凸版印刷;印刷过程与设备;	无线电电子学;真空电子技术;电子管;二极管;
运输;一般车辆;车轮;全部或主要由非金属材料制造的车轮、轮毂;	交通运输;公路运输;汽车工程;汽车结构部件;行走系统;车轮;轮毂;	农业工程;农业机械及农具;田间管理机械;肥料机械;施肥机;
运输;一般车辆;车轮;全部或主要由非金属材料制造的车轮、轮辋;	交通运输;公路运输;汽车工程;汽车结构部件;行走系统;车轮;轮辋;	电工技术;电机;发电机、大型发电机组（总论）;永磁发电机;
金属机械加工;金属的轧制;金属轧机机座，即由机架、轧辊和附件组成的组装件;轧辊轴;	金属学与金属工艺;金属压力加工;轧制;轧钢机械设备;轧机主列机构和设备;轧辊及轧辊轴承;	交通运输;公路运输;桥涵工程;各种桥梁;桥梁：按结构分;梁式桥;箱梁桥;
运输;船舶或其他水上船只;与船有关的设备;船上辅助设备;空气调节设备的配置;空气调节;	交通运输;水路运输;船舶工程;船舶机械;船舶辅机及设备;空气压缩机、空调设备;	化学;晶体学;晶体生长;晶体生长工艺;其他生长方法;
运输;船舶或其他水上船只;与船有关的设备;船上辅助设备;冷却的配置;冷却;	交通运输;水路运输;船舶工程;船舶机械;船舶辅机及设备;冷冻机械、冷凝器;	农业科学;农业工程;农业机械及农具;耕耘机具;犁;畜力犁;
运输;船舶或其他水上船只;与船有关的设备;船上辅助设备;加热的配置;加热;	交通运输;水路运输;船舶工程;船舶机械;船舶辅机及设备;热交换器、预热器;	化学工业;一般性问题;化工过程（物理过程及物理化学过程）;蒸汽的冷凝;
运输;一般车辆;车轮;由几个主要部分组成的轮辋;组合轮辋;	公路运输;汽车工程;汽车结构部件;行走系统;车轮;轮辋;组合式;	武器、军用器材;步兵武器、枪械及其他近战武器;枪械;步枪;
运输;铁路;铁路车辆的车体部件;用于铁路车辆照明装置的布置铁路;	交通运输;铁路运输;车辆工程;车体构造及设备;车辆设备;电气照明设备;	冶金工业;铁合金冶炼;各种铁合金冶炼;硅铁;
书写或绘图器具;书写或绘图用品;书写或绘图辅助用品;绘图板;	其他轻工业、手工业;文教用品制造工业;绘图工具;绘图板、绘图桌;	纺织工业、染整工业;针织;针织用机具;准备机械;
航空;宇宙航行;飞机;机身或类似部件共同的结构特征;	航空、航天;航空;航空器结构力学;结构分析与计算;机身;	无线电电子学、电信技术;电声器件;传声器;变阻式传声器;
飞行器;航空;宇宙航行;飞机;机身;窗;门;	航空、航天;航空;飞机构造与设计;机身;门窗;	无线电电子学、电信技术;传输线和波导;波导、波导管、波导传输线;
飞行器;航空;宇宙航行;飞机;机身;舱盖;座舱盖;	航空、航天;航空;飞机构造与设计;座舱;座舱盖;	建筑科学;市政工程;给水工程;配水工程;蓄水构筑物及其设备;水塔;
飞行器;航空;宇宙航行;飞机;机翼;机翼;	航空、航天;航空;飞机构造与设计;机翼;	化学工业;油脂和蜡的化学加工工业、肥皂工业;生产工艺;植物油制备方法;压榨法取油;
铸造;金属铸造;用相同工艺或设备的其他物质的铸造;带有真空压铸模型腔的压铸机;	工业技术;金属学与金属工艺;铸造;铸造机械设备;铸造机械;压力铸造机;真空压铸机;	医药、卫生;药学;药剂学;剂型;片剂;
一般制动控制系统或其部件;装在动力制动系统内的阀的结构;控制阀和放气阀;	工业技术;机械;机械零件及传动装置;气压传动;气压元件;控制阀;流量阀;	水利工程;水利枢纽、水工建筑物;取水、引水工程;泵站;
印刷;模印机;地址印刷机或类似的系列印刷机;油墨的配置或装置;	工业技术;轻工业、手工业;印刷工业;特种印刷;特种印刷：按油墨分;	电工技术;电气化、电能应用;家用电器及其他电器设备;清洁卫生用电器;洗衣机;
雪橇;有滑板的雪橇;可收缩或可折叠的雪橇;	体育;水上、冰上与雪上运动;雪上运动;雪车、雪橇、雪犁;	交通运输;公路运输;其他道路运输工具;自行车;
磨削;抛光;用于磨削或抛光的机床、装置或工艺;使用磨削或抛光带的机床或装置;	金属学与金属工艺;金属切削加工及机床;磨削加工与磨床;磨削加工工艺;抛光;	计算机技术;计算技术、计算机技术;电子数字计算机;外部设备;外存储器;
与船有关的设备;扫雷;扫雷;扫雷装置;消灭水雷的装置;	工业技术;武器工业;水中兵器;水雷;探雷、扫雷设备;	建筑科学;建筑材料;有机材料、建筑化工材料;建筑塑料及其制品;建筑塑料制品;门、窗等塑料配件和零件;
磨削;不仅以周边起作用的黏结砂轮或镶入磨块的砂轮;及其衬套或固定件;整体砂轮;	金属学与金属工艺;刀具、磨料、磨具、夹具、模具和手工具;磨具、研具;砂轮;	建筑科学;房屋建筑设备;房屋卫生技术设备;热水供应设备;热水供应系统;
运输;车用轮胎;轮胎充气;轮胎的更换;与轮胎有关的装置或布置;封闭的，例如环状的轮胎;	交通运输;公路运输;汽车工程;汽车结构部件;行走系统;车轮;轮胎;轮胎密封装置;	工业技术;轻工业、手工业;烟草工业;烟草加工工艺及制品;雪茄烟;
运输;一般车辆;车轮;用于车轮或脚轮的轴;轮辋;以轮辐安装方式为特点的;	交通运输;公路运输;汽车工程;汽车结构部件;行走系统;车轮;轮辋;辐板式;	医药、卫生;临床医学;治疗学;物理疗法、自然疗法;电疗法、磁疗法;
金属加工;焊接;局部加热切割;电弧焊接或电弧切割;电弧切割、刨削、表面缺陷清除或清除表面金属;	工业技术;金属学与金属工艺;焊接、金属切割及金属粘接;金属切割及设备;电弧切割及设备;	无线电电子学、电信技术;半导体技术;一般性问题;半导体器件制造工艺及设备;表面处理;
磨削;用于磨削或抛光的机床、装置或工艺;使用磨削或抛光带的机床或装置;用于磨削平面;	金属学与金属工艺;金属切削加工及机床;磨削加工与磨床;磨削加工工艺;平面磨削;	工业技术;电工技术;独立电源技术（直接发电）;蓄电池;碱性蓄电池;
提升;牵引;起重机;用于起重机的载荷吊挂元件或装置;缆索起重机;	机械、仪表工业;起重机械与运输机械;起重机械;各种用途起重机(含缆索起重机);	测绘学;摄影测量学与测绘遥感;非地形摄影测量;近影摄影测量;
与船有关的设备;扫雷;扫雷;扫雷装置;消灭水雷的装置;	武器工业;爆破器材、火炸药;爆破器材;扫雷器材;	植物学;植物分类学（系统植物学）;被子植物亚门;十字花科;
特种印刷品;单页的临时装订;文件卡片;合订卡片;	文教用品制造工业;簿册、活页印制;卡片;	铁路运输;车辆工程;车体构造及设备;车辆设备;给水、卫生设备;
塑料的加工;塑料的成型或连接;注射成型;所用的设备;	合成树脂与塑料工业;机械与设备;制品加工成型设备;	化学肥料工业;氮肥;铵态氮肥;硝酸铵;
用于打捞或搜索水下目标的装置;破损，搁浅或沉没船只的打捞;船只部件或装备的打捞;	交通运输;水路运输;船舶工程;航海技术管理与救助打捞;打捞工程;沉船打捞;	轻工业、手工业;印刷工业;凹版印刷;印版的制作;
金属冲压;与基本无切削金属加工有关的辅助加工;挤压工件或挤压机部件的冷却或加热;	工业技术;金属学与金属工艺;金属压力加工;挤压;有色金属及合金挤压;	农业科学;水产、渔业;水产捕捞;渔具与捕鱼设备;钓鱼具;
磨削、抛光或刃磨用的工具;研磨体或研磨板的物理特征;研磨体或研磨板的成分特征;	金属学与金属工艺;金属切削加工及机床;磨削加工与磨床;磨削加工工艺;研磨加工;	化学;高分子化学（高聚物）;杂链聚合物;链上含氧的聚合物;环氧树脂;
基本上无切削的金属机械加工;金属冲压;锻造;锤击;压制;与锻压机联合的锻锤;	金属学与金属工艺;金属压力加工;锻造、锻压与锻工;锻造用机械与设备;锻锤;其他锻锤;	公路运输;汽车工程;电气设备及附件;照明与信号系统;停刹车信号装置;
机床;刨削;拉削;拉床或拉削装置的附件;	金属学与金属工艺;金属切削加工及机床;拉削加工与拉床;	水利工程;水工材料;水工混凝土和砂浆;砂浆;水泥砂浆;
金属加工;剪切;剪床或剪切设备;剪床的组合;同时切开和割断;	金属学与金属工艺;金属压力加工;轧制辅助设备;剪切机;	铁路运输;车辆工程;车体构造及设备;车辆设备;给水、卫生设备;
运输;一般车辆;车辆的连接件;牵引连接器;牵引装置;以类型为特点的牵引装置或拖曳装置;	交通运输;公路运输;汽车工程;汽车结构部件;汽车附属装置;牵引装置;鞍式牵引装置;	机械工业;机械零件及传动装置;机械传动机构;摩擦传动;摩擦分合装置;
基本上无切削的金属机械加工;金属冲压;锻造;锻造炉;锻造炉;	金属压力加工;锻造、锻压;锻造用机械与设备;锻炉及工具;锻炉;	测绘学;摄影测量学与测绘遥感;非地形摄影测量;近影摄影测量;
机床;金属加工刨削;仅包含旋转和直线运动，如用于螺旋槽的切削;	金属切削加工及机床;刨削加工、刨床;工具运动刨床;旋转盘刨床、螺旋刨床;	金属学与金属工艺;金属切削加工及机床;齿轮加工及齿轮机床;齿轮其他加工机床;
磨削;用于磨削的机床、装置;研磨机床或装置;附件;研具;	金属学与金属工艺;磨具、模具和手工具;磨具、研具;研具;	铁路运输;铁路线路工程;线路构造;钢轨联接及扣件;螺栓;
运输;提升;升降机;自动扶梯或移动人行道;自动扶梯或移动人行道的控制;	交通运输;公路运输;交通工程与交通管理;交通系统;交通道;行人与人行道;	无线电电子学、电信技术;通信;通信保密与通信安全;通信安全技术;
运输;无轨陆用车辆;畜拉车;车的底架或行走装置;	交通运输;车辆工程;车体构造及设备;车体与底架;	化学工业;感光材料工业;机械与设备;干燥设备;
金属加工;焊接;电弧焊接或电弧切割;用于非接合目的的焊接，如堆焊;	金属学与金属工艺;焊接、金属切割及金属粘接;焊接工艺;堆焊及补焊;	食品工业;水产加工工业;水产制品;鱼粉、鱼翅;
用轧制方法制造特殊的金属物品;如农具;叉;耙;	农业工程;农业机械及农具;表土耕作机械;耙;	农业科学;畜牧;普通畜牧学;畜牧业的机具及设备;
机床;金属加工;车削;车削或基本上需要使用车床加工的方法;	金属切削加工及机床;车削加工及车床（旋床）;联合车床;	工业技术;金属学与金属工艺;焊接、金属切割及金属粘接;焊接工艺;钎焊;
一般的物理或化学的方法或装置;化学方法，催化作用;催化剂的一般载体;	化学工业;试剂与纯化学品的生产;催化剂;催化剂制备工艺;催化剂载体;	无线电电子学、电信技术;通信;通信保密与通信安全;通信安全技术;
运输;无轨陆用车辆;机动车;挂车;转向机构零件的位置，例如转向盘;	交通运输;公路运输;汽车工程;汽车结构部件;转向系统;转向系零部件;	化学工业;非金属元素及其无机化合物化学工业;硼及其无机化合物;硼;
机床;金属加工;组合加工;有程序控制的组合单元的机械;	金属学与金属工艺;金属切削加工及机床;程序控制机床及其加工;	电工技术;电气化、电能应用;家用电器及其他电器设备;清洁卫生用电器;电熨斗;
一般的物理或化学的方法或装置;化学或物理方法，催化作用;一般以其形态或物理性质为特征的催化剂;	化学;物理化学（理论化学）、化学物理学;化学动力学、催化作用;催化;催化剂;催化剂的种类;	机械、仪表工业;机械零件及传动装置;转动机件;轴承;滚动轴承;高速滚动轴承;
离心装置或离心机;离心机;用于在离心机中排气或形成真空;	真空技术;真空获得技术及设备;真空泵;机械真空泵;离心真空泵;	金属学与金属工艺;金属切削加工及机床;磨削加工与磨床;磨削加工工艺;抛光;
用于实现化学工艺过程的离心装置或离心机;离心机;用于离心机的其他附件;	化学;分析化学;元素及化合物的分离方法;物相分析;超离心机法;	音乐;器乐理论与演奏法;打击乐理论和演奏法;小鼓、大鼓;
运输;铁路;铁路车辆的转向架;;转向架的类型;	铁路运输;机车工程;机车构造;走行部分;转向架;	化学工业;爆炸物工业、火柴工业;点火、点爆材料;雷管;
运输;船舶或其他水上船只;与船有关的设备;船用设备;船体结构;	交通运输;水路运输;船舶工程;各种船舶;军用舰艇;结构;船体结构;	动物医学;动物医学（兽医学）;家畜卫生及防疫;兽医卫生保健组织;兽医器材及药品管理;
运输;船舶或其他水上船只;与船有关的设备;船用设备;船体结构;	交通运输;水路运输;船舶工程;各种船舶;船舶：按船体结构分;	一般工业技术;摄影技术;摄影机具与设备;摄影设备;特技摄影装置;
运输;铁路;铁路车辆的种类或车体部件;卫生设备;	铁路运输;车辆工程;车体构造及设备;车辆设备;给水、卫生设备;	测绘学;普通测量学、地形测量学;高程测量;气压高程测量;
运输;无轨陆用车辆;机动车;挂车;其他类目不包含的可偏转轮的转向机构;	交通运输;公路运输;汽车工程;汽车结构部件;转向系统;车轮转向;	教育、体育;体育;其他体育运动;击剑;
纸或纸板或类似纸的方式加工的材料的加工;纸张;复合变形和层压，与层压结合;	工业技术;轻工业、手工业;造纸工业;造纸工艺;纸品加工工艺;层压加工、复合加工;	汽车工程;汽车发动机;往复式发动机;部件、零件;起动系统;电力起动;
运输;铁路;铁路车辆的移位或调车;调车或近距离拖运设备;	铁路运输;铁路运输管理工程;调车工作;调车场及调车设备;	农业科学;农业工程;农业机械及农具;耕耘机具;犁;
飞行器;航空;飞机;直升飞机;起落架;减震器;弹簧减震器;	航空、航天;航空;飞机构造与设计;起落装置;起落架减震器;	轻工业、手工业;工艺美术制品工业;民间工艺美术制品;假面具、脸谱;
运输;一般车辆;适用于货运、或运输的车辆;	交通运输;机车工程;各种用途机车;货运机车;	化学工业;纤维素质的化学加工工业;虫胶工业;
印刷;印版或箔;印版;用石料制作;	轻工业;印刷工业;凹版印刷;印版的制作;	化学工业;化学纤维工业;再生纤维;硝酸纤维素纤维;
印刷;印刷机械或印刷机;丝网印刷机;	印刷工业;其他印刷;孔版印刷;丝网印刷;	农业科学;水产、渔业;水产捕捞;渔具与捕鱼设备;钓鱼具;
运输;铁路;机车;机动有轨车;蒸汽机车或蒸气有轨车;	交通运输;铁路运输;机车工程;蒸汽机车;蒸汽机部分;	金属学;磨料、磨具;磨料;其他磨料;
运输;无轨陆用车辆;自行车;可伸缩或可折叠的自行车;	交通运输;公路运输;其他道路运输工具;自行车;	航空、航天;航空;各类型航空器;短距和垂直升降航空器;直升飞机、旋翼机;
印刷;办公或其他商业用的印刷设备或装置;印刷设备或机械;	轻工业、手工业;印刷工业;一般性问题;机械与设备;印刷设备;	机械、仪表工业;机械零件及传动装置;转动机件;联轴器、离合器;
铸造;金属铸造;其他物质的铸造;金属连续铸造;	金属学与金属工艺;铸造;有色金属铸造;轻金属铸造;	交通运输;铁路运输;机车工程;燃气轮机车;电气设备;
铸造;金属铸造;其他物质的铸造;铸造车间;	金属学与金属工艺;铸造;铸造车间;	金属学与金属工艺;金属压力加工;轧制辅助设备;剪切机;
一般车辆;车用轮胎;非充气胎或实心轮胎;	橡胶工业;橡胶制品;轮胎;实心轮胎;	农业科学;农业基础科学;肥料学;农家肥料;堆肥、沤肥;
磨削;磨料或微粒材料的喷射;磨料选择;	金属学;磨料、磨具;磨料;其他磨料;	农业工程;农业机械及农具;田间管理机械;中耕除草、培土机械;除草机;
印刷;印刷版的制造或复制工艺;橡胶印版的制作;	轻工业、手工业;印刷工业;凹版印刷;印版的制作;	轻工业、手工业;体育器具制造工业;军事体育器具;野营器具;
印刷;印刷机械或印刷机;转印印刷设备;	轻工业、手工业;印刷工业;机械与设备;印刷设备;	造纸工业;制浆工艺;各种纸浆;蔗渣浆;
运输;铁路;铁路交通管理;与轨道相连的电气设备;	交通运输;铁路运输;机车工程;燃气轮机车;电气设备;	轻工业、手工业;工艺美术制品工业;民间工艺美术制品;假面具、脸谱;
夹持的工具;工件夹持装置;装配夹具;	航空发动机制造;装配;装配工夹具;	工业技术;建筑科学;房屋建筑设备;机电设备;电梯工程;
运输;铁路;铁路交通管理;调车场的转辙系统;	铁路运输;铁路运输管理工程;调车工作;调车场及调车设备;	工业技术;电工技术;电器;继电器;电继电器;电磁继电器;
铸造;金属铸造;其他物质的铸造;铸造后的剩余材料，如浇口及冒口的切割;	金属学与金属工艺;铸造;铸造工艺;浇注及凝固;浇口及冒口;	公路运输;隧道工程;隧道施工;隧道衬砌施工;
铸造;金属铸造;其他物质的铸造;铸造后的剩余材料，如浇口及冒口的切割;	金属学与金属工艺;铸造;铸造机械设备;铸件落砂和清理设备;去除浇口、冒口;	公路运输;汽车工程;汽车结构部件;转向系统;转向器;曲柄传动式;
机床;金属加工;螺纹切制;螺纹切制;专用自动机床;	金属学与金属工艺;金属切削加工及机床;螺纹加工及螺纹加工机床;	化学工业;油脂和蜡的化学加工工业;油脂工业产品及副产品;副产品加工及利用;蜡;
机床;金属加工;螺纹切制;螺纹切制;专用自动机床;用磨削;	金属切削加工及机床;磨削加工与磨床;磨削加工工艺;螺纹磨削;	工业技术;原子能技术;加速器;循环加速器;回旋加速器;等时性回旋加速器;
一般的化学的方法或装置;混合，溶解、乳化、分散;用作乳化剂，增湿剂，分散剂的物质;	化学工业;试剂与纯化学品的生产;表面活性剂;表面活性剂的应用;乳化剂、分散剂、增溶剂;	其他轻工业、手工业;玩具制造工业;各种玩具：按用途分;玩偶的服饰、用具;
运输;一般车辆;与车辆动力装置的进气、排气的布置;与动力装置燃气进气或排气结合的布置;	交通运输;公路运输;汽车工程;汽车发动机;往复式发动机;部件、零件;配气机构;进排气系统;	化学工业;染料及中间体工业;各种结构的合成染料;靛系染料;
化学;冶金;无机化学;砷的化合物;	化学工业;非金属元素及其无机化合物化学工业;砷及其无机化合物;	植物学;植物分类学（系统植物学）;被子植物亚门;天南星科;
化学;染料;有机染料或用于制造染料的有关化合物;还原性染料的隐色体;靛类染料的;	化学工业;染料及中间体工业;各种结构的合成染料;靛系染料;	铁路运输;铁路线路工程;路基加固与防护;防雪、防冰冻及设备;
水、废水、污水或污泥的处理;水、废水或污水的处理;加热法;	环境科学、安全科学;废物处理与综合利用;废水的处理与利用;技术方法;	变压器;电力变压器;油浸式电力变压器;自耦变压器;
化学;冶金;有机化学;无环或碳环化合物;氰酸的衍生物;	化学;有机化学;脂肪族含氮化合物;氰酸及异氰酸的有机衍生物;	一般工业技术;制冷工程;制冷机械和设备;制冷设备;精馏及其设备;
化学;冶金;无机化学;金属的化合物;超铀元素的化合物;	化学工业;金属元素的无机化合物化学工业;金属元素的无机化合物;超铀元素的无机化合物;	化学工业;试剂与纯化学品的生产;离子交换剂;离子交换剂的使用方法;分批操作法（混床法）;
化学;冶金;铁的冶金;改变黑色金属的物理结构;热处理过程的控制或调整;	工业技术;金属学与金属工艺;金属学与热处理;热处理;铸铁热处理;	往复式发动机;部件、零件;配气机构;气门及驱动机构;
化学;黏合剂;基于氯丁二烯的均聚物或共聚物的黏合剂;胶乳;	化学工业;橡胶工业;胶乳;合成胶乳;氯丁胶乳（聚氯丁二烯胶乳）;	交通运输;水路运输;船舶工程;各种船舶;船舶：按船体结构分;
化学;无机化学;金属镁的化合物，或稀土金属的化合物;镁的化合物;	化学工业;金属元素的无机化合物化学工业;第Ⅱ族金属元素的无机化合物;镁的无机化合物;	无线电电子学、电信技术;通信;数据通信;各种数据传输系统;数据交换系统;
化学;肥料;肥料制造;氮肥;含有其他铵盐或氨的肥料，如煤气水;	工业技术;化学工业;化学肥料工业;氮肥;铵态氮肥;硝酸铵;	印刷工业;其他印刷;孔版印刷;丝网印刷;
表面化学处理;电解法除外的化学法金属材料清洗及除油;金属材料清洗或酸洗用的设备;	金属学与金属工艺;金属学与热处理;热处理;热处理机械与设备;辅助设备;酸洗设备;	计算机技术;计算技术、计算机技术;电子模拟计算机;运算放大器和控制器;运算器;
化学;有机化学;无环或碳环化合物;砜;亚砜;	化学;有机化学;脂肪族化合物（无环化合物）;亚砜、砜及硫化物;	工业技术;轻工业、手工业;造纸工业;造纸工艺;纸品加工工艺;层压加工、复合加工;
石油;燃料;液化石油气;气体燃料;液化石油气;液化石油气;	汽车工程;汽车用燃料、润滑料;液化可燃气燃料;液化石油气;	公路运输;汽车工程;汽车发动机;旋转活塞式发动机;部件;缸体、缸盖、活塞;
化学;有机化学;无环或碳环化合物;硫氰酸或异硫氰酸的衍生物;	化学;有机化学;脂肪族化合物（无环化合物）;硫氰酸及异硫氰酸的有机衍生物;	化学工业;一般性问题;化工过程（物理过程及物理化学过程）;蒸汽的冷凝;
化学;染料;涂料;有机染料或用于制造染料的有关化合物;由其他偶氮化合物制备的偶氮染料;	工业技术;化学工业;染料及中间体工业;各种结构的合成染料;偶氮染料;单偶氮染料;	工业技术;电工技术;独立电源技术（直接发电）;蓄电池;碱性蓄电池;
化学;炼焦工业;含碳物料的干馏生产煤气、焦炭、焦油或类似物;其他炼焦炉;	工业技术;化学工业;炼焦化学工业;煤的高温干馏;炼焦;炼焦炉;	电工技术;电气化、电能应用;家用电器及其他电器设备;清洁卫生用电器;洗衣机;
化学;有机化学;无环或碳环化合物;含有氮原子之间以单键相连的链的化合物;肼;	化学;有机化学;无环化合物;脂肪族含氮化合物;羟氨及联氨衍生物;肼类;	轻工业、手工业;食品工业;乳品加工工业;各种乳制品;奶粉;
冶金;铁的冶金;铁或钢的冶炼;金属热还原法，如铝热还原法;	冶金工业;有色金属冶炼;金属提炼;火法提炼;热还原法;铝热法;	金属切削加工及机床;车削加工及车床（旋床）;联合车床;
化学;有机高分子化合物;其制备或化学加工;油、脂肪或蜡的组合物;其衍生的组合物;蜡;	化学工业;油脂和蜡的化学加工工业;油脂工业产品及副产品;副产品加工及利用;蜡;	化学工业;化学纤维工业;合成纤维;其他改性合成纤维;
化学;炼焦工业;含碳物料的干馏生产焦炭、焦油;固体含碳物料干馏;	工业技术;化学工业;炼焦化学工业;煤的高温干馏;炼焦;炼焦过程;	武器工业;弹药、引信;火工品;引信雷管;电雷管;
化学;天然树脂;黏合剂;基于由只在主链中形成含硫的;聚硫醚;聚硫醚-醚;	工业技术;化学工业;合成树脂与塑料工业;聚合类树脂及塑料;聚醚类;聚硫醚;	轻工业、手工业;印刷工业;一般性问题;机械与设备;排版设备;
化学;天然树脂;黏合剂;基于聚砜的黏合剂;聚砜;聚醚砜;	化学工业;合成树脂与塑料工业;聚合类树脂及塑料;聚醚类;聚砜;	给水工程;取水工程;水源;水源勘测;
高分子化合物的组合物;含木质素材料的组合物;木质纤维材料;	轻工业、手工业;造纸工业;原料及辅助物料;植物纤维;木质纤维;	自动化技术;计算技术、计算机技术;程序设计、软件工程;软件工程;
肥料;肥料制造;有机肥料;自家庭或市镇垃圾制成的肥料;生物堆肥;	农业科学;农业基础科学;肥料学;农家肥料;堆肥、沤肥;	化学工业;染料及中间体工业;各种结构的合成染料;偶氮染料;双偶氮染料;
化学;染料;有机染料或用于制造染料的有关化合物;由重氮化及偶合制备的其他偶氮染料;	化学工业;染料及中间体工业;各种结构的合成染料;偶氮染料;单偶氮染料;	冶金工业;有色金属冶炼;一般性问题;金属提炼;湿法冶炼;分离;
冶金;铁的冶金;铁或钢的冶炼;高炉炼生铁;	冶金工业;铁合金冶炼;冶炼方法;高炉冶炼;	金属学与金属工艺;铸造;铸造机械设备;铸件落砂和清理设备;去除浇口、冒口;
冶金;铁的冶金;铁或钢的冶炼;高炉炼生铁;特殊成分炉渣的炼制;	工业技术;冶金工业;炼铁;高炉熔冶过程;造渣;特种炉渣;	化学工业;化学肥料工业;氮肥;氰氨态氮肥;氰氨化钙;
化学;高分子化合物的组合物;含氮的，高分子化合物的组合物;聚胺;	化学;高分子化学（高聚物）;杂链聚合物;链上含氮的聚合物;聚胺;	机械、仪表工业;机械零件及传动装置;转动机件;轴承;滚动轴承;滚柱轴承;
化学;有机高分子化合物;酯;酯;	化学;有机化学;脂肪族化合物;酯;	建筑科学;建筑施工机械和设备;混凝土机械与设备;混凝土及砂浆搅拌机、搅拌车;混凝土搅拌机;
化学;炸药;火柴;炸药或热剂的组合物;用单种物质作炸药;如氯酸盐、高氯酸盐的组合物;	化学工业;爆炸物工业、火柴工业;猛性炸药;混合猛性炸药;氯酸盐与过氯酸盐炸药;	体育;体操运动;竞技体操;平衡木;
冶金;黑色或有色金属合金;合金;铁基合金;含硅的;	冶金工业;铁合金冶炼;各种铁合金冶炼;硅铁;	交通运输;铁路运输;车辆工程;货车;罐车;
冶金;黑色或有色金属合金;合金;铁基合金;含铬的;	工业技术;冶金工业;铁合金冶炼;各种铁合金冶炼;铬铁;	金属压力加工;锻造、锻压;锻造用机械与设备;自由锻水压机;
化学;涂料;基于含羧基橡胶的涂料组合物;胶乳;	化学工业;橡胶工业;胶乳;合成胶乳;其他胶乳;	轻工业、手工业;造纸工业;制浆工艺;制浆法;化学制浆;
化学;炸药;火柴;火柴;火柴的制造;火柴的机械加工;	化学工业;爆炸物工业、火柴工业;火柴工业;机械与设备;	冶金工业;一般性问题;有色冶金炉;烧结用炉;回转炉;
化学;有机化学;含周期表第5或15族元素的化合物;磷化合物;	化学;有机化学;元素有机化合物;第5族元素有机化合物;磷有机化合物;	航空、航天;航空;飞机构造与设计;机身、座舱;座舱盖、整流片、整流罩;
黑色或有色金属合金;用热处理法或用热加工法改变有色金属或合金的物理结构;铝或铝基合金;	金属学与金属工艺;金属学与热处理;热处理;有色金属及其合金的热处理;铝及其合金的热处理;	工业技术;金属学与金属工艺;金属压力加工;挤压;有色金属及合金挤压;
黑色或有色金属合金;用热处理法或用热加工法改变有色金属或合金的物理结构;铜或铜基合金;	金属学与金属工艺;金属学与热处理;热处理;有色金属及其合金的热处理;铜及其合金的热处理;	化学工业;橡胶工业;橡胶胶粘剂;
黑色或有色金属合金;用热处理法或用热加工法改变有色金属或合金的物理结构;镁或镁基合金;	金属学与金属工艺;金属学与热处理;热处理;有色金属及其合金的热处理;镁及其合金的热处理;	工业技术;武器工业;火炮;加农炮;
化学;有机高分子化合物;烃与矿物油的共聚物，如石油树脂;	化学工业;合成树脂;聚合类树脂;焦油系树脂;石油树脂;	公路运输;汽车工程;汽车发动机;往复式发动机;各种类型往复式发动机;气体燃料发动机;
化学;有机高分子化合物;高分子物质的处理或生产过程;高分子的交联;	化学工业;高分子化合物工业（高聚物工业）;生产过程;改性处理;交联法;	工业技术;化学工业;化学肥料工业;磷肥;硝酸磷肥;
肥料制造;有机肥料;人排泄物制成的肥料，如粪肥;由人粪便;	农业科学;农业基础科学;肥料学;农家肥料;人粪尿;	电工技术;电机;微电机;控制用微电机;自整角机;
化学;无机化学;金属的化合物;钼的化合物;	化学工业;金属元素的无机化合物;铬副族;钼的无机化合物;	航空、航天;航空;飞机构造与设计;机翼;
化学;无机化学;金属的化合物;钼的化合物;	化学;无机化学;金属元素及其化合物;铬副族;钼Mo;	化学工业;合成树脂与塑料工业;增强塑料、填充塑料;硼纤维增强塑料;
化学;生产，脂肪物质例如羊毛脂;羊毛脂的回收;	纺织工业、染整工业;毛纺织;原毛初加工;羊毛脂回收;	纺织工业、染整工业;针织;针织用机具;手套机;
化学;肥料;肥料制造;有机肥料，如用废物或垃圾制成的肥料;其他有机肥料;	水产、渔业;水产养殖技术;水产动物饵料及其营养;肥料;有机肥料;	其他轻工业、手工业;乐器制造工业;西乐器;弓弦乐器;
化学;生物化学;含有糖残基的化合物的制备;单糖;	生物科学;生物化学;糖;单糖;单糖转化衍生物;	交通运输;综合运输;管道运输;管道结构与设计;管件;
化学;生物化学;含有糖残基的化合物的制备;单糖;	化学;有机化学;天然化合物;糖;单糖及其衍生物;单糖;	原子能技术;各种核反应堆、核电厂;核电厂（核电站）;
化学;生物化学;含有糖残基的化合物的制备;多糖;	化学;有机化学;天然化合物;糖;多糖;	化学工业;染料及中间体工业;各种结构的合成染料;偶氮染料;双偶氮染料;
化学;生物化学;含有糖残基的化合物的制备;多糖;	生物科学;生物化学;糖;其他多糖;粘多糖;	化学工业;化学纤维工业;一般性问题;原料与辅助物料;再生纤维原料;
化学;生物化学;发酵合成目标化合物;多糖;	其他化学工业;发酵工业;其他发酵工业;聚多糖;	化学工业;染料及中间体工业;各种性能的合成染料;碱性染料;
生物化学;含有糖残基的化合物的制备;二糖;	生物科学;生物化学;糖;二糖;蔗糖;	食品工业;制糖工业;各种糖的生产;葡萄糖、果糖;
生物化学;含有糖残基的化合物的制备;麦芽糖;	食品工业;制糖工业;各种糖的生产;麦芽糖;	机械、仪表工业;机械零件及传动装置;转动机件;联轴器;
化学;生物化学;发酵合成目标化合物;葡萄糖;	食品工业;制糖工业;各种糖的生产;葡萄糖、果糖;	机械、仪表工业;机械零件及传动装置;转动机件;轴承;
化学;生物化学;发酵合成目标化合物;果糖;	食品工业;制糖工业;各种糖的生产;葡萄糖、果糖;	地质、矿产普查与勘探;钻探工程;钻具及工具;钻进工具;
化学;染料;有机染料或用于制造染料的有关化合物;双偶氮及多偶氮染料;双偶氮染料;	化学工业;染料及中间体工业;各种结构的合成染料;偶氮染料;双偶氮染料;	能源与动力工程;蒸汽动力工程;蒸汽锅炉;各种类型锅炉;火管锅炉;
化学;炼焦工业;含碳物料的干馏生产焦炭、焦油;炼焦炉的其他部件;	工业技术;化学工业;炼焦化学工业;煤的高温干馏;炼焦;炼焦炉;	矿业工程;矿山机械;采掘机械;露天矿采掘机械;
化学;炼焦工业;含碳物料的干馏生产焦炭、焦油;炼焦炉的其他部件;	工业技术;化学工业;炼焦化学工业;土法炼焦;简易炼焦炉;	建筑科学;建筑施工;各项工程与工种;模板工程;各种模板;
水、废水、污水或污泥的处理;水、废水或污水的生物处理;	市政工程;排水工程;污水、污泥的处理及利用;	市政工程及公用设备;消防;消防设备;灭火装置;
化学;有机高分子化合物;高分子化合物的组合物;环氧树脂的组合物;	化学;高分子化学（高聚物）;杂链聚合物;链上含氧的聚合物;环氧树脂;	金属学与金属工艺;金属学与热处理;热处理;热处理机械与设备;辅助设备;酸洗设备;
冶金;钢的冶炼;碳钢的冶炼;转炉炼钢;转炉构造、结构;	冶金工业;炼钢;氧气转炉炼钢;氧气顶吹转炉炼钢法;炉型结构;	电工技术;电工材料;磁性材料、铁氧体;永磁材料、永久磁铁;
冶金;钢的冶炼;碳钢的冶炼;转炉炼钢;废气或烟尘的去除;	冶金工业;炼钢;氧气转炉炼钢;氧气顶吹转炉炼钢法;废气除尘;	电声技术和语音信号处理;语音信号处理;语音合成;
冶金;钢的冶炼;碳钢的冶炼;转炉炼钢;吹炼的调节或控制;	冶金工业;炼钢;转炉炼钢;熔炼过程及操作;吹炼;	电工技术;电器;开关电器、断路器;各种开关;旋转和滑动开关;
冶金;钢的冶炼;碳钢的冶炼;转炉炼钢;造渣;	冶金工业;炼钢;转炉炼钢;熔炼过程及操作;造渣;	冶金工业;有色金属冶炼;金属提炼;火法提炼;热还原法;铝热法;
冶金;钢的冶炼;碳钢的冶炼;电炉炼钢;造渣;	冶金工业;炼钢;电炉炼钢;熔炼过程及操作;造渣;	轻工业、手工业;纺织工业、染整工业;一般性问题;纺织工业机械与设备;机织设备;
化学;黏合剂;黏合剂;橡胶的黏合剂;	化学工业;橡胶工业;橡胶胶粘剂;	轻工业、手工业;工艺美术制品工业;民间工艺美术制品;木偶制作;
生物化学;果汁酒;其制备;葡萄酒的制备;	食品工业;酿造工业;各种酒及其制造;葡萄酒;	纺织工业、染整工业;非织造布;各类非织造布;粘合法非织造布;
冶金;冶金;原材料的预处理;矿石的预处理;焙烧、烧结;	冶金工业;冶炼原料及矿石预处理;矿石预处理、烧结;	炼钢机械与生产自动化;炼钢生产自动化;炉料和钢水自动称量;
冶金;冶金;原材料的预处理;废料的预处理;	冶金工业;冶炼原料及矿石预处理;金属废料;	无线电电子学、电信技术;电子元件、组件;微波传输控制元件;波导定向耦合器;
冶金;冶金;原材料的预处理;矿石的预处理;	冶金工业;冶炼原料及矿石预处理;矿石;	农业工程;农业机械及农具;田间管理机械;肥料机械;施肥机;
冶金;冶金;有色金属的处理;原材料的预处理;矿石或废料的预处理;制团;制粒;制团;	冶金工业;冶金机械、冶金生产自动化;有色冶金机械;原料处理机械;制团、制粒机械;	水利工程;水工材料;水工混凝土和砂浆;砂浆;水泥砂浆;
对金属材料的镀覆;金属材料表面处理;熔融态覆层材料喷镀法;喷镀方法;	金属腐蚀与保护、金属表面处理;金属表面防护技术;金属覆层保护;喷镀法;	工业技术;金属学与金属工艺;金属学与热处理;热处理;铸铁热处理;
水、废水、污水或污泥的处理;水、废水或污水的生物处理;	环境科学;废物处理与综合利用;废水的处理与利用;技术方法;	自动化技术;计算技术、计算机技术;电子数字计算机;外部设备;外存储器;
染料;涂料;填充浆料;基于无机物质的涂料组合物;水泥;	水利工程;水工材料;水工混凝土和砂浆;砂浆;水泥砂浆;	公路运输;汽车工程;汽车结构部件;制动系统;制动器;鼓式;
化学;有机高分子化合物;高分子化合物;在高分子主链中形成的高分子化合物;	化学工业;高分子化合物工业（高聚物工业）;原料与辅助材料;合成高分子化合物;	汽车工程;汽车发动机;部件、零件;曲轴、飞轮及扭振减震器;
化学;有机高分子化合物;在高分子主链中形成含硅键合;聚硅氧烷;	化学;有机化学;元素有机化合物;第Ⅳ族元素有机化合物;硅有机化合物;硅氧烷;	医药、卫生;临床医学;治疗学;物理疗法、自然疗法;电疗法、磁疗法;
化学;染料;涂料;有机染料或用于制造染料的有关化合物;活性染料;	工业技术;化学工业;染料及中间体工业;各种性能的合成染料;活性染料;	轻工业、手工业;纺织工业、染整工业;非织造布;各类非织造布;针刺法非织造布;
化学;冶金;无机化学;碱金属，即钠、钾的化合物;钠、钾或一般碱金属的硝酸盐;	化学工业;金属元素的无机化合物化学工业;碱金属元素的无机化合物;钠的无机化合物;	航空、航天;航空;航空器结构力学;结构分析与计算;机身;
化学;冶金;有机化学;有机化学的一般方法;所用的装置;卤化;	化学工业;一般性问题;化学反应过程;一般化学反应过程;卤化、卤化剂;	无线电电子学、电信技术;基本电子电路;脉冲技术、脉冲电路;脉冲的产生、脉冲发生器;间歇振荡器;
化学;冶金;铁的冶金;铁或钢的冶炼;高炉用热风炉;砖砌热风炉;	工业技术;冶金工业;炼铁;炼铁炉（高炉）;热风炉;砌筑、维修;	机械、仪表工业;机械零件及传动装置;转动机件;轴承;滑动轴承;塑料滑动轴承;
化学;肥料;肥料制造;产生二氧化碳的肥料;其他无机肥料;	工业技术;化学工业;化学肥料工业;其他无机肥料;	轻工业、手工业;印刷工业;机械与设备;印刷设备;
化学;无机化学;非金属元素;其化合物;惰性气体;其化合物;	化学;无机化学;非金属元素及其化合物;零族元素、惰性气体;	矿业工程;矿山机械;采掘机械;露天矿采掘机械;
化学;有机化学;未知结构的化合物;抗菌素;	化学工业;农药工业;杀菌剂;抗菌素;	化学工业;硅酸盐工业;玻璃工业;各种玻璃产品;玻璃纤维;
化学;有机化学;无环或碳环化合物;制备卤代烃的方法;用卤素取代;	化学;有机化学;各类有机化合物;卤素衍生物、卤代烃;	工业技术;化学工业;农药工业;除草剂;无机除草剂;
化学;燃料;不包含在其他类目中的燃料;固体燃料;	化学工业;燃料化学工业;燃料种类及性质;固体燃料;	食品工业;制糖工业;各种糖的生产;麦芽糖;
冶金;铁的冶金;生铁的加工处理;生铁的精炼;铸铁;铸铁的冶炼;	工业技术;冶金工业;炼铁;炼铁产品;铸造生铁;可锻铸铁;	建筑科学;建筑施工;各种预制构件;板、楼板;
化学;炼焦工业;含一氧化碳的工业气体;焦油、焦油沥青的加工;焦油的加工;	工业技术;化学工业;炼焦化学工业;煤的高温干馏;化学产品加工;焦油粗加工及其产品;	公路运输;桥涵工程;各种桥梁;桥梁：按结构分;悬索桥;
化学;肥料;肥料制造;氮肥;含氰氨化钙或其他氰氨化物的肥料;	化学工业;化学肥料工业;氮肥;氰氨态氮肥;氰氨化钙;	交通运输;机车工程;各种用途机车;货运机车;
染料;涂料;填充浆料;基于无机物质的涂料组合物;水泥;	水利工程;水工材料;水泥、掺加料和外加剂;水泥;灌浆水泥;	农学（农艺学）;耕作学与有机农业;一般耕作技术;整地;
化学;有机化学;无环或碳环化合物;制备卤代烃的方法;用卤素取代;	基本有机化学工业;各类有机化合物的生产;卤素衍生物、卤代烃;	毛发、羽毛加工及制品;假发、假须、假睫毛;
化学;冶金;燃料;固体燃料;	冶金工业;冶金燃料与燃烧;固体燃料及燃烧;	工业技术;冶金工业;铁合金冶炼;各种铁合金冶炼;铬铁;
冶金;铁的冶金;生铁的加工处理;生铁的精炼;铸铁;球墨铸铁的冶炼;	工业技术;冶金工业;炼铁;炼铁产品;铸造生铁;球墨铸铁;	金属学与金属工艺;刀具、磨料、磨具、夹具、模具和手工具;刀具;铣刀;
化学;冶金;无机化学;氧化物;	化学;无机化学;化学元素与无机化合物;氧化物、过氧化物;	化学工业;染料及中间体工业;各种结构的合成染料;偶氮染料;双偶氮染料;
冶金;含一氧化碳的工业气体;燃料;乙炔的湿法生产;用储气罐自动调节给水的乙炔发生器;	工业技术;金属学与金属工艺;焊接、金属切割及金属粘接;焊接设备;气焊设备;乙炔发生器;	汽车工程;汽车发动机;往复式发动机;各种类型往复式发动机;气体燃料发动机;
化学;肥料;肥料制造;有机肥料;混合肥料;混合物制造的肥料;	化学工业;化学肥料工业;复合肥料（混合肥料）;其他混合肥料;	建筑科学;建筑施工;各项工程与工种;模板工程;各种模板;
化学;玻璃;玻璃的制造、成型;玻璃成型的其他方法;	化学工业;硅酸盐工业;玻璃工业;生产过程与设备;成型工艺;	铁路运输;铁路线路工程;线路构造;钢轨;钢轨润滑、钢轨喷油器;
化学;有机化学;杂环化合物;杂环化合物;	化学;有机化学;杂环化合物;七节杂环;	电工技术;发电、发电厂;配电设备和电气接线;开关设备;
合金或有色金属的处理;合金;含铜的;	五金制品工业;原材料及辅料;铜及铜合金;	体育;体操运动;竞技体操;平衡木;
合金或有色金属的处理;合金;含铜的;	金属材料;有色金属、稀有金属及其合金材料;铜及铜合金;	大气科学（气象学）;大气探测仪器及设备;湿度测定仪器;湿度计;
化学;有机化学;杂环化合物;杂环化合物，含六元环;	化学;有机化学;杂环化合物;含单异原子的六节杂环;	玩具制造工业;餐具、炊具、浴具;
化学;肥料;肥料制造;磷肥;用无机酸;用硝酸（硝基磷酸盐）;	工业技术;化学工业;化学肥料工业;磷肥;硝酸磷肥;	无线电电子学、电信技术;无线电设备、电信设备;终端设备;
化学;无机化学;非金属元素;其化合物;硼;其化合物;硼;硼化物;	化学工业;非金属元素及其无机化合物化学工业;硼及其无机化合物;硼;	建筑科学;建筑设计;房屋细部构造设计;烟囱;
化学;玻璃;釉或搪瓷釉的化学成分;搪瓷;釉;	化学工业;搪瓷工业;施釉;涂搪瓷方法和装饰方法;	基本电子电路;振荡技术、振荡器;振荡器;机械振荡器;
化学;无机化学;碱金属的卤化物;氟化物;	地质学;矿物学;矿物分类;卤化物;氟化物;	计算机技术;电子数字计算机;各种电子数字计算机;
化学;火柴;起爆或点火装置;化学点火具;点火剂;非电雷管;雷管;	化学工业;爆炸物工业、火柴工业;点火、点爆材料;雷管;	石油、天然气工业;石油机械设备与自动化;钻井机械设备;井架;
化学;有机化学;糖类;及其衍生物;糖化基团的化合物;单糖;	化学;有机化学;天然化合物;碳水化合物、糖;单糖及其衍生物;单糖;	力学;流体力学;普通流体力学;流体动力学;
化学;有机高分子化合物;其制备或化学加工;聚硫醚;	化学工业;聚合类树脂及塑料;聚醚类;聚硫醚;	机械、仪表工业;机械零件及传动装置;转动机件;轴承;滑动轴承;塑料滑动轴承;
化学;无机化学;金属铍的化合物;铍的化合物;	化学工业;金属元素的无机化合物化学工业;铍的无机化合物;	电工技术;电器;电阻器、电位器;固定电阻器;
化学;冶金;无机化学;金属镭的化合物;镭的化合物;	化学工业;金属元素的无机化合物化学工业;镭的无机化合物;	汽车工程;汽车发动机;旋转活塞式发动机;部件;密封结构;
化学;染料;有机染料或用于制造染料的有关化合物;靛类染料;	化学工业;染料及中间体工业;各种结构的合成染料;靛系染料;	能源与动力工程;内燃机;汽油机;构造;传动装置(驱动装置);
化学;动物或植物油、脂、脂肪物质或蜡;生产，例如通过压榨原材料或从废料中萃取;压榨法;	化学工业;油脂和蜡的化学加工工业、肥皂工业;生产工艺;植物油制备方法;压榨法取油;	工业技术;机械、仪表工业;泵;内燃泵;
化学;冶金;合金;非金属纤维或细丝;氧化物陶瓷纤维;	化学工业;化学纤维工业;无机纤维;矿物纤维;陶瓷纤维;	汽车工程;汽车发动机;往复式发动机;部件、零件;起动系统;电力起动;
化学;染料;有机染料或用于制造染料的有关化合物;双偶氮或多偶氮染料;双偶氮染料;	化学工业;染料及中间体工业;各种结构的合成染料;偶氮染料;四偶氮染料;	交通运输;公路运输;道路工程;道路养护与维修;路面的养护与维修;洒水、清扫、防尘;
化学;染料;有机染料或用于制造染料的有关化合物;双偶氮或多偶氮染料;三偶氮染料;	化学工业;染料及中间体工业;各种结构的合成染料;偶氮染料;三偶氮染料;	公路运输;汽车工程;汽车发动机;旋转活塞式发动机;部件;缸体、缸盖、活塞;
化学;染料;有机染料或用于制造染料的有关化合物;双偶氮或多偶氮染料;四偶氮染料;	化学工业;染料及中间体工业;各种结构的合成染料;偶氮染料;双偶氮染料;	化学工业;硅酸盐工业;玻璃工业;各种玻璃产品;玻璃纤维;
冶金;冶金;黑色或有色金属合金;合金或有色金属的处理;合金;铍基合金;	金属学与金属工艺;金属学;金属材料;有色金属及其合金;轻有色金属及其合金;铍;	化学工业;金属元素的无机化合物;铬副族;钼的无机化合物;
化学;玻璃;玻璃的制造;波纹或碎纹玻璃的制造;	化学工业;硅酸盐工业;玻璃工业;生产机械制造;	机械、仪表工业;机械零件及传动装置;转动机件;轴承;滑动轴承;塑料滑动轴承;
化学;有机高分子化合物;其制备或化学加工;虫胶;	化学工业;纤维素质的化学加工工业;虫胶工业;	轻工业、手工业;印刷工业;一般性问题;机械与设备;印刷设备;
化学;有机高分子化合物;其制备或化学加工;松香;	化学工业;油脂和蜡的化学加工工业;副产品加工及利用;松香;	轻工业、手工业;食品工业;乳品加工工业;各种乳制品;干酪;
冶金;覆层的电解或电泳生产工艺方法;工件的电解法接合;非金属电镀层;	金属学与金属工艺;金属表面处理;金属表面防护技术;金属复层保护;电镀法;	摄影技术;摄影机具与设备;摄影设备;摄影机;立体摄影机;
化学;有机高分子化合物;其制备或化学加工;无机酸纤维素酯的制备;硝酸纤维素;	化学工业;纤维素化学加工工业;生产工艺;硝酸纤维素酯（硝化纤维素）;	化学工业;金属元素的无机化合物化学工业;铍的无机化合物;
化学;多糖类;无机酸纤维素酯的制备;硝酸纤维素;	化学工业;化学纤维工业;再生纤维;硝酸纤维素纤维;	军事技术;武器、军用器材;炮兵武器;迫击炮;
冶金;乙炔的湿法生产;乙炔发生器的零部件;乙炔发生器的安全装置;	金属学与金属工艺;焊接、金属切割及金属粘接;焊接设备;气焊设备;乙炔发生器;	交通运输;公路运输;汽车工程;汽车结构部件;行走系统;车轮;轮毂;
化学;冶金;无机化学;金属的化合物;锗的化合物;	化学工业;金属元素的无机化合物化学工业;锗的无机化合物;	轻工业、手工业;印刷工业;凹版印刷;印版的制作;
化学;橡胶的处理或化学改性;橡胶胶乳的处理;胶乳的化学或物理处理;	化学工业;橡胶工业;一般性问题;橡胶及胶乳生产工艺;胶乳生产工艺;	化学;分析化学;元素及化合物的分离方法;物相分析;超离心机法;
化学;有机化学;杂环化合物;含有1个氮原子的六元环的杂环化合物;	化学;有机化学;杂环化合物;含单异原子的六节杂环;	建筑科学;建筑设计;房屋细部构造设计;墙、隔墙;
化学;黏合剂;动物胶或明胶的制备;明胶;	化学工业;胶粘剂工业;动物胶;明胶;	工业技术;矿业工程;矿山安全与劳动保护;矿井通风;通风管理与通风构筑物;
化学;有机化学;杂环化合物;杂环化合物，含七元环;	化学;化学;有机化学;杂环化合物;七节杂环;	五金制品工业;五金制品;日用五金制品;炉灶及灶具;
化学;晶体生长;单晶生长;冷凝气化物或材料挥发法的单晶生长;	化学;晶体学;晶体生长;晶体生长工艺;其他生长方法;	工业技术;冶金工业;炼铁;炼铁产品;铸造生铁;球墨铸铁;
化学;由矿物或矿渣制成的纤维的表面处理;矿物纤维，矿物棉;	化学工业;化学纤维工业;无机纤维;矿物纤维;石棉纤维;	建筑科学;建筑施工机械和设备;混凝土机械与设备;混凝土及砂浆搅拌机、搅拌车;砂浆搅拌机;
化学;玻璃;由玻璃制成的纤维的表面处理;玻璃纤维;	化学工业;硅酸盐工业;玻璃工业;各种玻璃产品;玻璃纤维;	计算机技术;计算技术、计算机技术;电子模拟计算机;运算放大器和控制器;运算放大器;
电解或电泳工艺;电铸;工件的电解法接合;所用的装置;电铸;	航空制造工艺;制造工艺过程及设备;电解加工、电化学加工;电铸;	机械、仪表工业;机械零件及传动装置;机械传动机构;啮合传动;齿轮及齿轮传动;
啤酒;啤酒的酿造;酿造装置;	酿造工业;各种酒及其制造;啤酒;	原子能技术;核反应堆工程;反应堆部件及其设计、制造;燃料元件和组件;结构及设计;
啤酒;啤酒的酿造;啤酒发酵方法;	酿造工业;各种酒及其制造;啤酒;	其他轻工业、手工业;乐器制造工业;中国民族乐器;打击乐器;
化学;肥料;肥料制造;氮肥;硝酸铵肥料;	化学肥料工业;氮肥;铵态氮肥;硝酸铵;	原子能技术;各种核反应堆、核电厂;核电厂（核电站）;
纺织;织物等的处理;洗涤;纺织品的洗涤;具有固定洗涤容器，洗衣机;	电工技术;电气化、电能应用;家用电器及其他电器设备;清洁卫生用电器;洗衣机;	数理科学和化学;物理学;等离子体物理学;辐射与测量;
纺织;编织;针织;不靠使用特殊机器生产织物或产品的纬编针织工艺;使用上述工艺生产的产品;	轻工业、手工业;纺织工业、染整工业;针织;针织工艺;针织新工艺;	建筑科学;建筑设计;工业建筑;构筑物;塔形、柱形等构筑物;烟囱;
纺织;织物等的处理;洗涤;纺织品的洗涤、干燥、熨烫、压平或打折;刷式洗衣机;	电工技术;电气化、电能应用;家用电器及其他电器设备;清洁卫生用电器;洗衣机;	无线电电子学;真空电子技术;电子管;二极管;
纺织;缝纫;绣花;簇绒;缝纫;数台缝纫机合在一起的缝纫机组;	轻工业、手工业;纺织工业、染整工业;一般性问题;纺织工业机械与设备;机织设备;	电工技术;电气化、电能应用;家用电器及其他电器设备;清洁卫生用电器;洗衣机;
纺织;织物等的处理;纺织品的干燥、熨烫、压平或打折;手熨斗的加压、升高或导向装置;	电工技术;电气化、电能应用;家用电器及其他电器设备;清洁卫生用电器;电熨斗;	文教用品制造工业;绘图工具;绘图板、绘图桌;
纺织;编织;花边制作;针织;饰带;非织造布;饰带;其他类不包括的带、绦或锭带等;装饰用纺织品;	轻工业、手工业;纺织工业、染整工业;针织;各类针织物;花边及装饰物;	轻工业、手工业;烟草工业;烟草加工工艺及制品;卷烟制造;抽梗、压梗;
纺织;造纸;织造;机织织物;织造方法;织机;透孔织物;	轻工业、手工业;纺织工业、染整工业;一般性问题;混纺织物;普通织物;	轻工业、手工业;印刷工业;装订技术、装帧技术;装订过程与设备;
纺织;织造;机织织物;织造方法;一般织造方法;机织法;	轻工业、手工业;纺织工业、染整工业;一般性问题;机织（织造工艺）;	公路运输;汽车工程;汽车结构部件;仪表;指示信号灯;
纺织;天然或化学纤维;纺纱;纤维的预处理，如纺纱准备;纤维处理手工设备;	轻工业、手工业;纺织工业、染整工业;化学纤维纺织;机械与设备;纺纱设备;	武器工业;水中兵器;深水炸弹及发射装置;火箭式发射装置;
造纸;造纸机;制造连续纸幅的纸机湿部;长网造纸机的网前箱;	轻工业、手工业;造纸工业;机械与设备;造纸机械;长网造纸机;	公路运输;汽车工程;汽车发动机;旋转活塞式发动机;部件;缸体、缸盖、活塞;
纺织;织物等的处理;纺织品的染色或印花;与机械处理联用的染色或印花法;	轻工业、手工业;纺织工业、染整工业;染整工业;印花;印花方法;	矿山安全与劳动保护;矿山排水与堵水;排水、堵水设备及排水系统;
纺织;天然或化学的线或纤维;纺纱或纺丝;纺丝溶液的制备;	化学纤维工业;一般性问题;生产工艺;纺丝原液制备;	农业工程;农业机械及农具;耕耘机具;犁;机力犁;铧式犁;
对纤维的处理;被处理的纤维或制成的纤维制品的化学成分;碳纤维;	化学工业;化学纤维工业;合成纤维;特种纤维;碳纤维系纤维;	工业技术;机械、仪表工业;仪器、仪表;坐标器、计算机具、计数器;计数器;
造纸;造纸;制浆药液的再生;含纤维素原料制浆;制浆工艺方法;	轻工业、手工业;造纸工业;制浆工艺;制浆法;化学制浆;	无线电电子学、电信技术;电视;电视同步系统;多节目源电视系统的同步;
纺织;天然或化学的纤维;纺纱或纺丝;纤维的预处理;分解含纤维物质，使纤维回收利用;	纺织工业、染整工业;一般性问题;纺织纤维（纺织原材料）;废纤维的回收与利用;	军事技术;武器、军用器材;炮兵武器;迫击炮;
纺织;织物等的处理;纺织品的干燥;烘干;	纺织工业;毛纺织;原毛初加工;烘干;	武器、军用器材;步兵武器、枪械及其他近战武器;枪械;步枪;
纺织;纱线;纱或线;纱或线;	纺织工业;混纺织物;纱线;纱或线;	电工技术;电器;开关电器、断路器;熔断器、保险丝装置;限流熔断器;
造纸;造纸;压光机;压光机;	造纸工业;造纸工艺;干燥、压光;	工业技术;机械、仪表工业;泵;容积泵;隔膜泵;
造纸;造纸;造纸机辅助设备;刮刀;	造纸工业;机械与设备;辅助设备器材;刀片;	环境科学;废物处理与综合利用;废水的处理与利用;技术方法;
纺织;编织;针织;针织;经编机;米兰尼斯平型经编机;	纺织工业、染整工业;针织;针织用机具;经编针织机;	金属学与金属工艺;金属学;金属材料;有色金属及其合金;轻有色金属及其合金;铍;
纺织;纱线;纱或线;如花式纱;	纺织工业;针织;原料（针织用纱）;花式纱;	天文学;天文观测设备与观测资料;天文仪器;天象仪;
对纤维的处理;被处理的纤维或制成的纤维制品的化学成分;合成纤维;	化学工业;化学纤维工业;合成纤维;其他改性合成纤维;	地质、矿产普查与勘探;钻探工程;钻具及工具;钻进工具;
造纸;造纸;制造连续纸幅的造纸机的压榨部;湿压榨;	轻工业、手工业;造纸工业;造纸工艺;上网、压榨;	交通运输;铁路运输;机车工程;内燃机车;牵引电机及电器;牵引电器;
纺织;织物等的处理;纺织品的染色或印花;有关染色或印花纺织品;后处理;	工业技术;轻工业、手工业;纺织工业、染整工业;染整工业;印花;印花后处理;	电工技术;电器;电容器;电容器:按结构分;固定式电容器;
纺织;织物等的处理;纺织品的染色或印花;有关染色或印花纺织品;转移印花;	工业技术;轻工业、手工业;纺织工业、染整工业;染整工业;印花;印花方法;	交通运输;水路运输;船舶工程;船舶机械;船舶辅机及设备;冷冻机械、冷凝器;
纺织;织物等的处理;洗涤;纺织品的洗涤;带容器的洗衣机;	电能应用;家用电器及其他电器设备;清洁卫生用电器;洗衣机;	金属学与金属工艺;焊接、金属切割及金属粘接;焊接设备;气焊设备;乙炔发生器;
纺织;针织;非织造布;通过此类工艺或设备制造的织物，如非织造布;针刺机;	轻工业、手工业;纺织工业、染整工业;非织造布;非织造布工艺;针刺法工艺;	冶金工业;铁合金冶炼;冶炼方法;高炉冶炼;
纺织;针织;非织造布;通过此类工艺或设备制造的织物，如非织造布;针刺机;	轻工业、手工业;纺织工业、染整工业;非织造布;各类非织造布;针刺法非织造布;	农业科学;农业工程;农业机械及农具;耕耘机具;表土耕作机械;镇压器;
纺织;纤维素的生产;纤维原料或其机械处理;纤维原料或其机械处理;	化学工业;化学纤维工业;一般性问题;原料与辅助物料;再生纤维原料;	太阳能技术;太阳能转换装置和设备;聚光器;
洗涤;纺织品的洗涤;带容器的洗衣机，如既能洗涤又能离心脱水的容器;	电气化、电能应用;家用电器及其他电器设备;清洁卫生用电器;洗衣机;	电工技术;电器;开关电器、断路器;各种开关;旋转和滑动开关;
墙壁、地面或类似物的覆盖材料，如油毡、油布、油毛毡;油毛毡，如涂沥青的纤维网;	建筑科学;建筑材料;防水、防潮材料，嵌缝、密封材料;油毡、防水卷材;油毛毡、油毡纸;	汽车工程;汽车发动机;部件、零件;曲柄连杆机构;曲轴;
编织;针织;通过针织动作补布;通过织补;	生活服务技术;家务管理;家庭缝纫、织补;	天文学;天文观测设备与观测资料;天文仪器;天象仪;
纺织品的染色或印花;按照所用染料、颜料分类的;用碱性染料;	化学工业;染料及中间体工业;各种性能的合成染料;碱性染料;	化学工业;高分子化合物工业（高聚物工业）;生产过程;改性处理;交联法;
纺织品的染色或印花;按照所用染料、颜料或助剂分类的;用酸性染料;	化学工业;染料及中间体工业;各种性能的合成染料;酸性染料;	工业技术;化学工业;炼焦化学工业;煤的高温干馏;炼焦;炼焦炉;
纺织;织物等的处理;地毯、小地毯;地毯、小地毯;	中国工艺美术;织染、服装、刺绣工艺美术;地毯、挂毯;	工业技术;武器工业;火箭、导弹;导弹;制导与控制;飞行控制系统;
造纸;造纸;纸的浸渍或涂布;涂布纸;	造纸工业;产品;各种加工纸;涂布加工纸;	化学工业;染料及中间体工业;各种结构的合成染料;偶氮染料;三偶氮染料;
纺织;花边制作;针织;饰带;花边;花边;编织物或花边;如枕头花边;	轻工业、手工业;纺织工业、染整工业;针织;各类针织物;花边及装饰物;	交通运输;公路运输;汽车工程;汽车结构部件;转向系统;转向系零部件;
造纸;造纸;用机械方法精制纸浆悬浮液;	造纸工业;制浆工艺;各种纸浆;废纸浆;	食品工业;酿造工业;各种酒及其制造;葡萄酒;
造纸;造纸;造纸机;制造连续纸幅的整套纸机;圆网机型的;	轻工业、手工业;造纸工业;机械与设备;造纸机械;圆网造纸机;	工业技术;机械、仪表工业;泵;内燃泵;
纺织;花边制作;针织;饰带;花边花边;手工编织或织花边的工具或器械;	轻工业、手工业;纺织工业、染整工业;针织;各类针织物;花边及装饰物;	畜牧;普通畜牧学;饲料;饲料加工处理与贮藏、保存方法;
造纸;纤维素的生产;制浆药液的再生;纤维素纸浆，例如木浆;	轻工业、手工业;造纸工业;制浆工艺;各种纸浆;木浆;	矿业工程;矿山设计与建设;凿岩爆破工程;掏槽方法;
纺织;纺纱或纺丝;制作化学长丝;长丝、线的生成;	轻工业、手工业;纺织工业、染整工业;丝纺织;丝纺织物;	金属学与金属工艺;金属切削加工及机床;镗削加工及镗床;卧式镗床;
纺织;缝纫;绣花;缝纫;缝纫机用送布机构;	轻工业、手工业;家务管理;家庭缝纫、织补;	工业技术;原子能技术;受控热核反应;热核反应堆;
洗涤;纺织品的洗涤;洗衣房系统或机器设备的配置;	房屋建筑设备;房屋卫生技术设备;卫生设备;洗衣房及其设备;	无线电电子学、电信技术;基本电子电路;脉冲技术、脉冲电路;脉冲的产生、脉冲发生器;间歇振荡器;
纺织;非织造布;制造纺织品;非织造布;用液态化学黏合剂固结;	纺织工业、染整工业;非织造布;各类非织造布;粘合法非织造布;	机车工程;蒸汽机车;锅炉部分;冷凝系统;冷凝器;
纺织;非织造布;制造纺织品;非织造布;用液态化学黏合剂固结;	纺织工业、染整工业;非织造布;非织造布工艺;化学粘合工艺;	水利工程;水利枢纽、水工建筑物;引水工程;冲砂放淤设施;冲砂闸;
造纸;造纸;制浆药液的再生;所需设备;蒸煮器;	轻工业、手工业;造纸工业;机械与设备;制浆机械;蒸煮设备;	交通运输;水路运输;船舶工程;航海技术管理与救助打捞;打捞工程;沉船打捞;
制造纺织品，用纤维原料;纤维制成的非织造布;玻璃纤维;	化学工业;化学纤维工业;无机纤维;玻璃纤维;	轻工业、手工业;造纸工业;原料及辅助物料;植物纤维;木质纤维;
纺织;编织;针织;针织;经编针织工艺;	纺织工业;针织;针织工艺;经编工艺;	轻工业、手工业;制镜;镜子;
纺织;编织;针织;针织;针织工艺，器械或机器;	纺织工业、染整工业;针织;针织用机具;准备机械;	工业技术;原子能技术;加速器;循环加速器;同步加速器;
纺织;针织;针织;纬编针织用圆机;专用于生产手套;	纺织工业、染整工业;针织;针织用机具;手套机;	轻工业、手工业;家务管理;家庭缝纫、织补;
织物等的处理;纺织品的熨烫;熨斗;	家用电器;清洁卫生用电器;电熨斗;	大气科学（气象学）;云和降水测定仪器;雨量器、雨量计、量雪尺;
造纸;浆料或纸浆组合物;甘蔗渣的;	造纸工业;制浆工艺;各种纸浆;蔗渣浆;	酿造工业;各种酒及其制造;啤酒;
纺织品的染色或印花;染色;按照所用染料分类的;用还原染料;	染料及中间体工业;各种结构的合成染料;蒽醌染料;还原染料;	公路运输;汽车工程;汽车发动机;往复式发动机;各种类型往复式发动机;气体燃料发动机;
纺织品的染色或印花;染色;按照所用染料分类的;用分散染料;	染料及中间体工业;各种结构的合成染料;蒽醌染料;分散染料;	轻工业、手工业;印刷工业;印刷技术的应用;报纸印刷;
土层或岩石的钻进;采矿;采矿或采石;水力采矿方法;产生脉冲流体射流的装置;	矿业工程;矿山机械;水力采矿机械化设备;水力采掘机械;	能源与动力工程;蒸汽动力工程;蒸汽锅炉;各种类型锅炉;火管锅炉;
道路、铁路或桥梁的建筑;桥梁;桥梁零件;桥墩;桥台;	交通运输;公路运输;桥涵工程;桥梁构造;墩台结构（下部结构）;桥台;	化学工业;硅酸盐工业;玻璃工业;各种玻璃产品;玻璃纤维;
土层或岩石的钻进;采矿;竖井;隧道;平硐;地下室;井筒衬砌;衬砌物;	水利工程;水利工程施工;各种工程、工种;隧洞与地下工程;钻爆法施工;衬砌;	工业技术;矿业工程;矿山运输与设备;矿井提升;提升机;
道路、铁路或桥梁的建筑;桥梁;以支撑桥跨结构截面为特征的桥梁;箱型梁的;	交通运输;公路运输;桥涵工程;各种桥梁;桥梁：按结构分;梁式桥;箱梁桥;	服装工业、制鞋工业;制鞋工业;结构、部件及配件;鞋底、内底;
建筑物;专门用途的建筑物;停放汽车或类似车辆的建筑物，例如，汽车库;存放多辆车的车库;	交通运输;公路运输;汽车工程;汽车制造厂;车库;	轻工业、手工业;纺织工业、染整工业;丝纺织;丝纺织物;
采矿;矿井或隧道中或其自身的安全装置，通风;矿井或隧道的通风;风流的分配;风筒;	工业技术;矿业工程;矿山安全与劳动保护;矿井通风;通风管理与通风构筑物;	公路运输;汽车工程;电气设备及附件;照明与信号系统;停刹车信号装置;
道路、铁路或桥梁的建筑;街道清洗;喷湿或不喷湿路面清除道路或类似路面上的废物;洗刷设备;	交通运输;公路运输;道路工程;道路养护与维修;路面的养护与维修;洒水、清扫、防尘;	金属切削加工及机床;刨削加工、刨床;工具运动刨床;旋转盘刨床、螺旋刨床;
采矿;采矿或采石;露天矿的开采或运输机械;	矿业工程;矿山机械;采掘机械;露天矿采掘机械;	无线电电子学、电信技术;通信;通信保密与通信安全;通信安全技术;
建筑物;一般建筑物构造;屋顶;顶棚;屋顶;有关隔绝的屋顶构造;悬索屋顶;	建筑科学;建筑设计;房屋细部构造设计;屋顶（屋面）、屋檐;	一般工业技术;工业通用技术与设备;爆破技术;
道路、铁路的建筑;铁路轨道;铁路轨道附件;轨枕;	交通运输;铁路运输;铁路线路工程;线路构造;轨枕;	纺织工业、染整工业;非织造布;各类非织造布;粘合法非织造布;
道路的建筑;街道清洗;陆地清洗;喷湿或不喷湿路面清除道路或类似路面上的废物;	公路运输;道路工程;道路养护与维修;路面的养护与维修;洒水、清扫、防尘;	太阳能技术;太阳能转换装置和设备;聚光器;
采矿;矿井或隧道中或其自身的安全装置或排水;排水;	矿山安全与劳动保护;矿山排水与堵水;排水、堵水设备及排水系统;	计算机技术;电子数字计算机;基本电路;逻辑电路;
采矿;矿井或隧道中或其自身的安全装置或排水;排水;	矿业工程;矿山安全与劳动保护;矿山排水与堵水;排水、堵水方法;	工业技术;冶金工业;炼铁;炼铁炉（高炉）;热风炉;砌筑、维修;
采矿;矿井或隧道中或其自身的安全装置或排水;排水;	矿业工程;矿山机械;矿山固定机械设备;矿山排水设备;	能源与动力工程;内燃机;燃气轮机（燃气透平）;燃烧室;
固定建筑物;建筑物的闭合装置，例如，门、窗;特殊用途的门、窗;	工业技术;建筑科学;建筑设计;房屋细部构造设计;门、窗;	化学;高分子化学（高聚物）;杂链聚合物;链上含氧的聚合物;环氧树脂;
土层或岩石的钻进;采矿;采矿或采石;掏槽;	矿业工程;矿山设计与建设;凿岩爆破工程;掏槽方法;	工业技术;化学工业;炼焦化学工业;土法炼焦;简易炼焦炉;
土层或岩石的钻进;采矿;土层或岩石的钻进;钻头;岩心钻头;	地质、矿产普查与勘探;钻探工程;钻头、钻具及工具;钻头;	航空、航天;航空;飞机构造与设计;机翼;
土层或岩石的钻进;采矿;土层或岩石的钻进;钻头;岩心钻头;	石油机械设备与自动化;钻井机械设备;钻头、钻具与工具;	轻工业、手工业;纺织工业、染整工业;针织;各类针织物;花边及装饰物;
固定建筑物;隧道;隧道;其衬砌物;现场制衬砌物;	公路运输;隧道工程;隧道施工;隧道衬砌施工;	化工过程（物理过程及物理化学过程）;分离过程;单相系液态混合物的分离过程;
固定建筑物;给水;给水池的配置;用于公共的或类似用途的总给水系统;	建筑科学;市政工程;给水工程（上水道工程）;工业企业给水;给水系统;	航空、航天;航空;飞机构造与设计;机翼;翼上辅助装置;
固定建筑物;建筑物;模板;用以制作墙、楼板用的模壳，模板;	建筑科学;建筑施工;各项工程与工种;模板工程;各种模板;	矿业工程;矿山安全与劳动保护;矿山排水与堵水;排水、堵水方法;
固定建筑物;建筑物;屋面覆盖层;柔性材料屋面覆盖层;塑料的;	建筑科学;建筑材料;建筑化工材料;建筑塑料制品;塑料屋面材料;	能源与动力工程;水能、水力机械;水轮机;小型水轮机;
固定建筑物;水利工程;船舶提升设备或机械;船闸;船闸的泄水装置;	水路运输;通航建筑物;船闸;船闸尺度与构造;船闸输水系统;泄水设施;	电声技术和语音信号处理;语音信号处理;语音合成;
固定建筑物;水利工程;船舶提升设备或机械;船闸;竖井式船闸;	水路运输;通航建筑物与助航设备;船闸;各种船闸;井室船闸;	工业技术;原子能技术;加速器;循环加速器;回旋加速器;等时性回旋加速器;
固定建筑物;船舶提升设备或机械;船闸;船在船闸内航行所用的附属设备;	水路运输;通航建筑物与助航设备;船闸;船闸尺度与构造;船闸附属设备;	水路运输;船舶工程;船舶舾装设备;桅杆设备;
道路、铁路的建筑;铁路轨道;铁路轨道附件;轨道的一般结构;	铁路运输;铁路线路工程;线路构造;轨道;轨道结构、轨道设计;	粒子探测技术、辐射探测技术;中子和其他辐射探测器;中子探测器;
固定建筑物;桥梁的建筑;桥梁;一般的桥梁;	建筑科学;建筑设计;工业建筑;构筑物;桥梁;	机车工程;蒸汽机车;锅炉部分;冷凝系统;冷凝器;
固定建筑物;桥梁的建筑;桥梁;桁架桥;	各种桥梁;桥梁：按结构分;拱式桥;桁架拱桥;	体育器具制造工业;球类运动器具;网球、球网及附件;
固定建筑物;道路或桥梁的建筑;桥梁;悬索式斜拉桥;斜拉桥;	公路运输;桥涵工程;各种桥梁;桥梁：按结构分;斜拉桥;	体育;球类运动;高尔夫球;
固定建筑物;排水;下水道;排水构筑物;下水道的通风;	建筑科学;房屋建筑设备;排水设备;下水道的通气系统;	农业工程;农业机械及农具;种植机械;播种机;特殊结构播种机;
固定建筑物;水利工程;水利工程;拦河坝或堰的结构细部;冲砂闸;	水利工程;水利枢纽、水工建筑物;引水工程;冲砂放淤设施;冲砂闸;	一般工业技术;摄影技术;各种摄影技术;立体摄影;
道路的建筑;街道清洗;陆地清洗;将液体洒到道路或类似路面上;洒水车;	公路运输;道路工程;道路养护与维修;机动养路机械与设备;洒水车;	自动化技术及设备;机器人技术;机械手;专用机械手;
固定建筑物;给水;取水、集水或配水的装置或方法;泵站;	水利工程;水利枢纽、水工建筑物;取水、引水工程;泵站;	铁路运输;铁路线路工程;铁路养护与维修;除雪、防雪、防冰冻及设备;
土层或岩石的钻进;从井中开采油、气;钻井的设备;钻机;	石油、天然气工业;石油机械设备与自动化;钻井机械设备;钻机;	地质、矿产普查与勘探;钻探工程;钻具及工具;钻进工具;
土层或岩石的钻进;从井中开采油、气;钻机的支承装置，井架;	石油、天然气工业;石油机械设备与自动化;钻井机械设备;井架;	轻工业、手工业;造纸工业;机械与设备;制浆机械;蒸煮设备;
固定建筑物;疏浚;挖掘;疏浚;挖掘机;疏浚机;机械驱动的;	建筑科学;建筑施工机械和设备;土工机械、挖掘机械;挖掘机;	能源与动力工程;蒸汽动力工程;蒸汽锅炉;锅炉构造;水处理及给水装置;
道路、铁路或桥梁的建筑;桥梁;悬索式斜拉桥;悬索桥;	公路运输;桥涵工程;各种桥梁;桥梁：按结构分;悬索桥;	化学工业;磁性记录材料工业;原材料及辅助物料;载体;
建筑物;施工用具或其他建筑辅助设备，或其应用;楼梯，坡道;	建筑科学;建筑设计;房屋细部构造设计;楼梯、坡道、电梯;	金属学与金属工艺;金属切削加工及机床;镗削加工及镗床;卧式镗床;
建筑物;一般建筑物构造;墙;建筑物的墙，间壁墙;	建筑科学;建筑设计;房屋细部构造设计;墙、隔墙;	电工技术;电器;开关电器、断路器;熔断器、保险丝装置;限流熔断器;
水利工程;基础;水利工程;一般水利工程的设备、装置或方法;水工模型;	水利工程;水利工程基础科学;水力学;水工模型;水工模型试验;正态模型;	电气化、电能应用;家用电器及其他电器设备;清洁卫生用电器;洗衣机;
道路、铁路或桥梁的建筑;铁路轨道;铁路轨道附件;轨道上部结构;特殊支撑设备;	铁路运输;铁路线路工程;线路构造;轨道;轨道结构理论、轨道设计;轨道支撑及装置;	无线电电子学、电信技术;电视信号的传输;电视信号的光波传送系统、光放大器传输系统;
采矿;矿井或隧道中或其自身的安全装置，通风;空气的冷却或干燥;	矿业工程;矿山安全与劳动保护;矿井通风;通风系统、通风方法与设备;	轻工业、手工业;纺织工业、染整工业;一般性问题;机织（织造工艺）;
土层或岩石的钻进;采矿;竖井;隧道;反向凿井;	公路运输;隧道工程;隧道施工;竖井工程;	机械、仪表工业;机械零件及传动装置;机械传动机构;摩擦传动;摩擦分合装置;
道路、铁路或桥梁的建筑;铁路轨道;铁路轨道附件;交叉;交叉;突变交叉;	铁路运输;铁路运输管理工程;铁路枢纽;进站线路疏解、进路交叉;交叉;	其他轻工业、手工业;文教用品制造工业;笔;铅笔;
铁路轨道;铁路轨道附件;尖轨;尖轨附加器;与之有关的结构;	铁路运输;铁路线路工程;线路构造;尖轨与尖轨附加器、护轨;	轻工业、手工业;烟草工业;烟草加工工艺及制品;卷烟制造;抽梗、压梗;
固定建筑物;建筑物;楼板;楼板;用于隔绝的楼板结构;	建筑科学;建筑施工;各种预制构件;板、楼板;	轻工业、手工业;造纸工业;制浆工艺;制浆法;化学制浆;
道路、铁路的建筑;附属工程，防雪栅等的修建;防雪、防冰冻的设备;	铁路运输;铁路线路工程;路基加固与防护;防雪、防冰冻及设备;	矿业工程;矿山设计与建设;凿岩爆破工程;掏槽方法;
道路、铁路的建筑;附属工程，防雪栅等的修建;防雪、防冰冻的设备;	铁路运输;铁路线路工程;铁路养护与维修;除雪、防雪、防冰冻及设备;	化学工业;金属元素的无机化合物化学工业;金属元素的无机化合物;超铀元素的无机化合物;
固定建筑物;道路的建筑;防雪栅等的修建;防雪、侧风影响;	建筑科学;建筑结构;特种结构;防灾结构;防风、防雪结构;	无线电电子学、电信技术;传输线和波导;波导、波导管、波导传输线;
道路的建筑;附属工程，道路设备的修建;防眩光装置;防眩光装置;	公路运输;交通工程与公路运输技术管理;交通公害;眩光;	体育;体操运动;竞技体操;平衡木;
基础;基础;地下或水下结构物;土壤或岩石的改良或保护;	农业科学;农业基础科学;土壤学;土壤改良;其他土壤改良;	化学纤维工业;一般性问题;生产工艺;纺丝原液制备;
固定建筑物;建筑物;专门用途的建筑物或类似的构筑物;水塔;水塔;	建筑科学;市政工程;给水工程;配水工程;蓄水构筑物及其设备;水塔;	电工技术;电机;电机制造工艺及设备;一般制造工艺;
专门用途的建筑物或类似的构筑物;桅杆;桅杆装置;	水路运输;船舶工程;船舶舾装设备;桅杆设备;	医药、卫生;药学;药物基础科学;药物化学;有机药物化学;
固定建筑物;建筑物;专门用途的建筑物或类似的构筑物;烟囱;烟囱体;	建筑科学;建筑设计;工业建筑;构筑物;塔形、柱形等构筑物;烟囱;	金属学与金属工艺;磨具、模具和手工具;磨具、研具;研具;
固定建筑物;建筑物;专门用途的建筑物或类似的构筑物;烟囱;烟囱体;	建筑科学;建筑设计;房屋细部构造设计;烟囱;	工业技术;轻工业、手工业;烟草工业;烟草加工工艺及制品;雪茄烟;
采矿;采矿或采石;使矿物完全落离矿层的机械;单靠掏槽的;	矿业工程;矿山设计与建设;凿岩爆破工程;掏槽方法;	酿造工业;各种酒及其制造;啤酒;
土层或岩石的钻进;采矿;土层或岩石的钻进;其他钻具;	地质、矿产普查与勘探;钻探工程;钻具及工具;钻进工具;	机械、仪表工业;机械零件及传动装置;转动机件;轴承;滚动轴承;滚柱轴承;
固定建筑物;排水;下水道;下水管道系统;	建筑科学;房屋建筑设备;排水设备;下水道系统;	轻工业、手工业;烟草工业;烟草加工工艺及制品;卷烟制造;抽梗、压梗;
水利工程;地下或水下结构物;	水利工程;水工结构;水下结构;	能源与动力工程;特殊热能及其机械;太阳能技术;太阳能转换装置和设备;聚光器;
机械工程;工程元件或部件;轴;轴承;专用于旋转运动的滚动接触轴承;滚针轴承;滚针轴承;	工业技术;机械、仪表工业;机械零件及传动装置;转动机件;轴承;滚动轴承;滚针轴承;	工业技术;机械、仪表工业;泵;容积泵;隔膜泵;
一般机器或发动机;一般机器或发动机的冷却;液体冷却;冷却发动机或机器的其他零件的装置;	交通运输;公路运输;汽车工程;汽车发动机;旋转活塞式发动机;部件;冷却系统;	电工技术;电气化、电能应用;电气照明;灯泡、灯管;气体放电灯;
液体变容式机械;泵;具有柔性工作元件的机械、泵;具有板状柔性件，例如隔膜;	工业技术;机械、仪表工业;泵;容积泵;隔膜泵;	工业技术;金属压力加工;锻造用机械与设备;摩擦压力机;
一般机器或发动机;一般机器或发动机的冷却;冷却剂流量的控制;用冷却的空气作冷却剂;	航空;航空发动机;发动机附件系统;冷却系统;空气喷气发动机冷却系统;	交通运输;水路运输;船舶工程;船舶机械;船舶辅机及设备;冷冻机械、冷凝器;
机械工程;液体变容式机械;泵;由内燃机驱动;	工业技术;机械、仪表工业;泵;内燃泵;	造纸工业;造纸工艺;干燥、压光;
机械工程;蒸汽机;一般的或变容式的机器或发动机，如蒸汽机;调节、控制或安全装置;安全装置的校验操作;	能源与动力工程;蒸汽动力工程;蒸汽轮机（蒸汽透平、汽轮机）;构造;安全装置;	电工技术;电器;电感器、线圈、扼流圈;固定电感线圈;
机械工程;制冷或冷却;制冷机，制冷设备或系统;具有几个蒸发回路的压缩机、压缩装置或压缩系统;	工业技术;一般工业技术;制冷工程;制冷机械和设备;压缩机;	一般工业技术;摄影技术;各种摄影技术;立体摄影;
机械工程;工程元件或部件;为产生和保持机器或设备的有效运行的一般措施;润滑;用于润滑器或润滑系统的润滑油容器;	机械、仪表工业;机械学（机械设计基础理论）;机械摩擦、磨损与润滑;润滑;润滑器具;	建筑科学;建筑设计;房屋细部构造设计;墙、隔墙;
机械工程;燃烧发动机;热气或燃烧生成物的发动机装置;一般燃烧发动机;以使用气态燃料工作为特征的发动机;	公路运输;汽车工程;汽车发动机;往复式发动机;各种类型往复式发动机;气体燃料发动机;	金属学与金属工艺;焊接、金属切割及金属粘接;焊接设备;气焊设备;乙炔发生器;
燃烧设备;燃烧方法;只用固体燃料的燃烧方法或设备;适用于锅炉的燃烧设备，其燃烧室位于锅炉内部;	能源与动力工程;蒸汽动力工程;蒸汽锅炉;锅炉构造;燃烧装置;	化学工业;试剂与纯化学品的生产;催化剂;催化剂制备工艺;催化剂载体;
机械工程;工程元件或部件;传动装置;主要只包括凸轮、凸轮随动件以及螺杆和螺母机构的传动装置;	机械、仪表工业;机械零件及传动装置;机械传动机构;啮合传动;凸轮;	无线电电子学、电信技术;基本电子电路;脉冲技术、脉冲电路;脉冲调制、解调，脉冲调制器;
工程元件或部件;制动器;制动件与鼓轮，轮缘或类似件的圆周面和内表面均接合的制动器;	公路运输;汽车工程;汽车结构部件;制动系统;制动器;鼓式;	无线电电子学、电信技术;半导体技术;一般性问题;半导体器件制造工艺及设备;表面处理;
机械工程;炉灶;其他家用炉或灶;一般用途家用炉或灶的零部件;零部件;	轻工业、手工业;五金制品工业;五金制品;日用五金制品;炉灶及灶具;	建筑科学;房屋建筑设备;排水设备;下水道的通气系统;
机械工程;工程元件或部件;转动工程元件;轴承;装配轴承;装配滑动接触轴承;	机械、仪表工业;机械零件及传动装置;转动机件;轴承;滑动轴承;塑料滑动轴承;	文教用品制造工业;绘图工具;绘图板、绘图桌;
机械工程;工程元件或部件;转动工程元件;轴承;装配轴承;装配滚动接触轴承;	机械、仪表工业;机械零件及传动装置;转动机件;轴承;滚动轴承;高速滚动轴承;	机车工程;一般性问题;机车构造;走行部分;转向架;减振装置;
照明;照明;发光装置或其系统;矿工非电手灯;	电气化、电能应用;电气照明;各种用途的灯;矿灯;	市政工程;排水工程;污水、污泥的处理及利用;
武器;弹药;爆破;弹药引信;引信;用于地雷的;	武器工业;弹药、引信、火工品;引信;武器用引信;地雷引信;	工业技术;矿业工程;矿山运输与设备;矿井提升;提升机;
武器;弹药;爆破;弹药引信;引信;用于鱼雷、水雷或深水炸弹的;	武器工业;弹药、引信、火工品;引信;武器用引信;水中兵器引信;	基本电子电路;滤波技术、滤波器;各形滤波器;
机械工程;蒸汽的发生;蒸汽的发生方法;蒸汽锅炉;筒型蒸汽锅炉;锅炉体外部带辅助水管的;	工业技术;能源与动力工程;蒸汽动力工程;蒸汽锅炉;各种类型锅炉;水管锅炉;	农业科学;水产、渔业;水产捕捞;捕捞技术;网鱼法;抄网、掩网捕捞;
机械工程;工程元件或部件;传送旋转运动的联轴器;冲击联轴器;	机械、仪表工业;机械零件及传动装置;转动机件;联轴器;	建筑科学;建筑施工机械和设备;混凝土机械与设备;混凝土及砂浆搅拌机、搅拌车;混凝土搅拌机;
机械工程;一般机器的气流消音器;以消音方法为特点的消音装置;	交通运输;水路运输;船舶工程;船舶舾装设备;消音设备;	化学;有机化学;天然化合物;糖;多糖;
武器;武器;轻武器，例如手枪或步枪;肩射轻武器，例如步枪;	武器、军用器材;步兵武器、枪械及其他近战武器;枪械;步枪;	汽车工程;汽车发动机;往复式发动机;部件、零件;起动系统;电力起动;
机械工程;制冷或冷却;进行分离气体混合物成分的设备;通过精馏作用;	一般工业技术;制冷工程;制冷机械和设备;制冷设备;精馏及其设备;	武器工业;水中兵器;深水炸弹及发射装置;火箭式发射装置;
机械工程;燃烧设备;燃烧生成物或燃烧余渣的清除或处理;从燃烧室清除炉灰、炉渣;	能源与动力工程;蒸汽动力工程;蒸汽锅炉;运行;炉灰、炉渣的清除;	一般工业技术;制冷工程;制冷机械和设备;制冷设备;精馏及其设备;
机械工程;工程元件或部件;传动装置;主要只带有摩擦元件的传动装置;	机械、仪表工业;机械零件及传动装置;机械传动机构;摩擦传动;摩擦轮;	轻工业、手工业;印刷工业;平版印刷;印刷过程与设备;
机械工程;工程元件或部件;传动装置;主要只带有摩擦元件的传动装置;	机械、仪表工业;机械零件及传动装置;机械传动机构;摩擦传动;摩擦分合装置;	铁路运输;铁路线路工程;线路构造;尖轨与尖轨附加器、护轨;
机械工程;工程元件或部件;传动装置;主要只带有齿轮的传动装置;	机械工业;机械零件及传动装置;机械传动机构;啮合传动;齿轮及齿轮传动;	无线电电子学、电信技术;无线电设备、电信设备;终端设备;
机械工程;工程元件或部件;制动器;制动器的部件或零件;	公路运输;汽车工程;汽车结构部件;制动系统;制动器;其他;	交通运输;铁路运输;车辆工程;货车;罐车;
机械工程;工程元件或部件;传送旋转运动的联轴器;离合器;离合器的传动;	工业技术;机械、仪表工业;机械零件及传动装置;转动机件;联轴器、离合器;	纺织工业、染整工业;毛纺织;原毛初加工;羊毛脂回收;
机械工程;照明;与照明装置或系统的用途;车内照明装置;	车辆工程;车体构造及设备;车辆设备;电气照明设备;	铁路运输;车辆工程;车体构造及设备;车辆设备;给水、卫生设备;
机械工程;照明;与照明装置或系统的用途;车内照明装置;	机车工程;一般性问题;机车设备与材料;电气照明设备;	交通运输;铁路运输;车辆工程;车体构造及设备;车辆设备;电气照明设备;
机械工程;照明;与照明装置或系统的用途;车内照明装置;	汽车工程;汽车结构部件;照明与信号系统;照明灯;	机械、仪表工业;坐标器、计算机具、计数器;计数器;
机械工程;蒸汽的发生;蒸汽的发生方法;蒸汽锅炉;水管锅炉;	能源与动力工程;蒸汽动力工程;蒸汽锅炉;各种类型锅炉;水管锅炉;	化学工业;橡胶工业;胶乳制品;海绵类;
机械工程;工程元件或部件;减振装置;系统中振动的抑制;	机车工程;一般性问题;机车构造;走行部分;转向架;减振装置;	服装工业、制鞋工业;制鞋工业;结构、部件及配件;鞋底、内底;
机械工程;工程元件或部件;减震器;系统中振动的抑制;飞轮;	汽车工程;汽车发动机;部件、零件;曲轴、飞轮及扭振减震器;	化学;有机化学;天然化合物;碳水化合物、糖;单糖及其衍生物;单糖;
机械工程;工程元件或部件;曲轴机构的元件;转动工程元件;曲轴或连杆用的;	工业技术;机械、仪表工业;机械零件及传动装置;转动机件;连杆、曲柄;	无线电电子学、电信技术;电子元件、组件;电声器件;扬声器;立体声扬声器;
机械工程;工程元件或部件;曲轴机构的元件;转动工程元件;曲轴或连杆用的;	汽车工程;汽车发动机;部件、零件;曲柄连杆机构;曲轴;	电工技术;电机;发电机、大型发电机组;永磁发电机;
武器;弹药;爆炸装药，例如弹药;深水炸弹;	武器、军用器材;海军武器;水中武器;深水炸弹;	化学工业;爆炸物工业、火柴工业;猛性炸药;混合猛性炸药;氯酸盐与过氯酸盐炸药;
武器;弹药;爆炸装药，例如弹药;深水炸弹;	武器工业;水中兵器;深水炸弹及发射装置;各种深水炸弹;	农业工程;农业机械及农具;耕耘机具;犁;机力犁;铧式犁;
机械工程;炉;窑;一般馏炉、窑;开式烧结设备或类似设备;炉，窑;零部件;	一般性问题;化工机械与仪器、设备;化工用炉灶、化工窑;炉窑附属设备;	工业技术;矿业工程;矿山运输与设备;矿井提升;提升机;
加热;炉;一般馏炉、烘烤炉;开式烧结设备;回转炉;	工业技术;冶金工业;炼钢;炼钢炉;回转炉;	制鞋工业;制鞋工业;结构、部件及配件;鞋跟;
加热;炉;一般馏炉、烘烤炉;开式烧结设备;回转炉;	冶金工业;一般性问题;有色冶金炉;烧结用炉;回转炉;	金属学与金属工艺;金属切削加工及机床;齿轮加工及齿轮机床;齿轮其他加工机床;
工程元件或部件;紧固或固定构件，螺栓;连接件或连接;螺栓;	铁路运输;铁路线路工程;线路构造;钢轨联接及扣件;螺栓;	金属学与金属工艺;铸造;铸造车间;
流体压力执行机构;流体动力学;影响流体流动;	力学;流体力学;物理-化学流体动力学;界面和毛细流动;	无线电电子学;无线电导航;导航系统;宇宙飞行器导航系统;
机械工程;工程元件或部件;传动装置;用于传送运动的摩擦面的元件;摩擦元件;	机械工业;机械零件及传动装置;机械传动机构;摩擦传动;摩擦分合装置;	电工技术;电器;电阻器、电位器;固定电阻器;
机械工程;武器;武器;伪装工事;伪装;	军事技术;军事工程;工程技术一般作业;伪装;	工业技术;机械;机械零件及传动装置;气压传动;气压元件;控制阀;流量阀;
武器;武器;武器瞄准器;制导;用于自身推进导弹的方向控制系统;	工业技术;武器工业;火箭、导弹;导弹;制导与控制;飞行控制系统;	商品流通与市场;广告;广告策划与制作;
机械工程;发动机装置;旋转活塞式机器或发动机的密封装置;	汽车工程;汽车发动机;旋转活塞式发动机;部件;密封结构;	电工技术;电机;发电机、大型发电机组（总论）;
机械工程;照明;照明;特别适用于车辆外部的信号装置，方向指示灯;	公路运输;汽车工程;汽车结构部件;仪表;指示信号灯;	化学;物理化学（理论化学）、化学物理学;表面现象的物理化学;吸附;吸附理论;离子交换吸附作用;离子交换剂;
机械工程;照明;照明;特别适用于车辆外部的信号装置，刹车灯;	汽车工程;汽车结构部件;电气设备及附件;照明与信号系统;停刹车信号装置;	冶金工业;冶炼原料及矿石预处理;矿石;
机械工程;能源利用;利用太阳能产生机械功的装置;带聚积太阳能装置的;	能源与动力工程;特殊热能及其机械;太阳能技术;太阳能转换装置和设备;聚光器;	化学工业;试剂与纯化学品的生产;离子交换剂;离子交换剂的使用方法;电解法;
机械工程;蒸汽机;机器用的循环操作阀;滑动阀机构;	能源与动力工程;蒸汽动力工程;蒸汽机;构造;滑阀室;	教育、体育;体育;其他体育运动;击剑;
流体压力执行机构;流体动力学;影响流体流动;	力学;流体力学;普通流体力学;流体动力学;	武器、军用器材;海军武器;水中武器;深水炸弹;
燃烧发动机;热气或燃烧生成物的发动机装置;喷气推进装置;涵道风扇的装置;	航空;基础理论及试验;空气动力学;飞机空气动力学;涵道风扇空气动力学;	其他轻工业、手工业;体育器具制造工业;其他体育器具;登山运动器具;
机械工程;传送旋转运动的联轴器;离合器;内部控制的自动离合器;	机械、仪表工业;机械零件及传动装置;转动机件;联轴器、离合器;	工业技术;化学工业;农药工业;除草剂;无机除草剂;
加热;供热;住宅热水供应系统;集中供热系统;热水和蒸汽系统;	建筑科学;房屋建筑设备;房屋卫生技术设备;热水供应设备;热水供应系统;	轻工业、手工业;工艺美术制品工业;民间工艺美术制品;木偶制作;
加热;供热;住宅热水供应系统;集中供热系统;热水和蒸汽系统;	建筑科学;市政工程;城市集中供热;热水系统;	机械、仪表工业;起重机械与运输机械;运输机械;输送机辅助设备;抛料机;
炉;窑;烘烤炉;对出炉材料的装卸或处理;冷却;	冶金工业;炼钢;转炉炼钢;熔炼过程及操作;冷却;	工业技术;冶金工业;炼铁;炼铁炉（高炉）;热风炉;砌筑、维修;
燃烧发动机;除压缩点火之外的内燃机点火;与内燃机其他部件结构上组合一起的火花塞;	公路运输;汽车工程;汽车结构部件;电气设备及附件;点火系统;火花塞;	化学;化学;有机化学;杂环化合物;七节杂环;
炉;电弧炉;带有或不带有其他热源的电加热的，例如电弧炉;	工业技术;冶金工业;炼钢;炼钢炉;电炉;电弧炉;	植物学;植物分类学（系统植物学）;被子植物亚门;天南星科;
加热;炉;床式炉，例如反射炉;	铸造;铸造机械设备;熔炼设备;反射炉;	能源与动力工程;内燃机;汽油机;构造;点火系统;
计算或控制用的流体回路元件;无运动部件的回路元件;振荡器;	无线电电子学;基本电子电路;振荡技术、振荡器;振荡器;	化学工业;染料及中间体工业;各种结构的合成染料;偶氮染料;四偶氮染料;
机械工程;工程元件或部件;活塞;缸;一般压力容器;密封;活塞;筒状活塞;柱塞;	公路运输;汽车工程;汽车发动机;旋转活塞式发动机;部件;缸体、缸盖、活塞;	玩具制造工业;餐具、炊具、浴具;
一般热交换;通用热交换或传热设备的零部件;管件;管件的组件;	交通运输;综合运输;管道运输;管道结构与设计;管件;	食品工业;水产加工工业;水产制品;鱼粉、鱼翅;
一般机器或发动机;活塞往复运动的往复活塞式机器或发动机;	汽车发动机;往复式发动机;各种类型往复式发动机;	农业科学;园艺;果树园艺;浆果类;葡萄;
燃烧发动机;热气或燃烧产物的变容式发动机装置;有往复式活塞发动机;	汽车发动机;往复式发动机;各种类型往复式发动机;稀薄燃烧发动机;	金属学与金属工艺;金属压力加工;冷冲压（钣金加工）;深冲、拉延成型、拉深;
机械工程;燃烧发动机;内燃机点火;其他点火;	能源与动力工程;内燃机;汽油机;构造;点火系统;	轻工业、手工业;纺织工业、染整工业;一般性问题;机织（织造工艺）;
燃烧设备;只用固体燃料的燃烧设备;燃烧设备;	化工机械与仪器、设备;化学反应过程设备;化工燃烧设备;	航空、航天;航空;航空器结构力学;结构分析与计算;机身;
武器;弹药;爆破;爆炸装药;深水炸弹;	武器、军用器材;海军武器;水中武器;深水炸弹;	纺织工业;针织;针织工艺;经编工艺;
机械工程;武器;爆破;弹药;爆炸装药;弹药;练习或教练弹药;	武器工业;弹药、引信、火工品;弹药;炸弹;练习炸弹、试验炸弹;	建筑科学;建筑施工机械和设备;混凝土机械与设备;混凝土及砂浆搅拌机、搅拌车;
机械工程;传送旋转运动的联轴器;离合器;流体离合器;	机械、仪表工业;机械零件及传动装置;转动机件;联轴器、离合器;	工业技术;冶金工业;炼钢;炼钢炉;电炉;电弧炉;
机械工程;一般热交换;蒸汽或其他蒸气冷凝器;冷凝器;	机车工程;蒸汽机车;锅炉部分;冷凝系统;冷凝器;	电工技术;电器;控制器、接触器、起动器、电磁铁;电磁铁;制动电磁铁;
机械工程;蒸汽的发生;蒸汽锅炉;蒸汽锅炉的组成件;从锅炉内清除水的装置;	能源与动力工程;蒸汽动力工程;蒸汽锅炉;锅炉构造;水处理及给水装置;	交通运输;水路运输;船舶工程;船舶机械;船舶辅机及设备;空气压缩机、空调设备;
机械工程;燃烧设备;燃气轮机的燃烧室;连续燃烧室;	能源与动力工程;内燃机;燃气轮机（燃气透平）;燃烧室;	铁路运输;铁路线路工程;线路构造;轨道;轨道结构理论、轨道设计;轨道支撑及装置;
武器;导弹或鱼雷发射装置;鱼雷发射装置;用于海上鱼雷的;	武器工业;水中兵器;鱼雷及其发射装置;鱼雷发射装置;	轻工业、手工业;纺织工业、染整工业;一般性问题;机织（织造工艺）;
武器;导弹发射装置;火箭发射装置;用于火箭的;	武器工业;水中兵器;深水炸弹及发射装置;火箭式发射装置;	工业技术;机械、仪表工业;机械零件及传动装置;转动机件;轴承;滚动轴承;滚针轴承;
机械工程;蒸汽的发生;蒸汽锅炉;火箱型蒸汽锅炉，带有烟管或火管;	能源与动力工程;蒸汽动力工程;蒸汽锅炉;各种类型锅炉;火管锅炉;	建筑科学;建筑施工机械和设备;混凝土机械与设备;混凝土及砂浆搅拌机、搅拌车;混凝土搅拌机;
武器;弹药;爆炸装药;弹药;水雷;触发水雷;	武器工业;水中兵器;水雷;各种水雷;触发水雷;	食品工业;制糖工业;各种糖的生产;麦芽糖;
炉;烘烤炉;通用的炉的零部件或附件;装料;炉料控制;	冶金工业;炼钢;平炉炼钢;平炉操作技术;开炉装料;	无线电电子学、电信技术;电视;电视扫描系统;非线性扫描系统;
爆破;爆破;爆破技术的特定应用;	一般工业技术;工业通用技术与设备;爆破技术;	铁路运输;铁路线路工程;铁路养护与维修;除雪、防雪、防冰冻及设备;
炉;烘烤炉;通用的炉的零部件或附件;装料;炉料控制;	冶金工业;炼铁;高炉操作;开炉、配料;开炉、装料;	化学工业;染料及中间体工业;各种结构的合成染料;偶氮染料;四偶氮染料;
武器;爆破;武器;发射装置;迫击炮;	军事技术;武器、军用器材;炮兵武器;迫击炮;	能源与动力工程;内燃机;燃气轮机（燃气透平）;燃烧室;
武器;爆破;武器;发射装置;迫击炮;	工业技术;武器工业;火炮;迫击炮;	金属腐蚀与保护、金属表面处理;金属表面防护技术;金属覆层保护;喷镀法;
武器;爆破;武器;例如加农炮;发射装置，加农炮;	工业技术;武器工业;火炮;加农炮;	化学;有机化学;无环化合物;脂肪族含氮化合物;羟氨及联氨衍生物;肼类;
炉灶;其他家用炉或灶;炉或灶的零部件;液体燃料的炉或灶;	五金制品工业;五金制品;日用五金制品;炉灶及灶具;	能源与动力工程;蒸汽动力工程;蒸汽锅炉;锅炉构造;水处理及给水装置;
燃烧发动机;热气的发动机装置;同时以燃料-空气混合气压缩为特征的发动机;	汽车工程;汽车发动机;往复式发动机;各种类型往复式发动机;气体燃料发动机;	武器工业;弹药、引信、火工品;引信;武器用引信;地雷引信;
机械工程;液力机械或液力发动机;产生机械动力;水轮;	能源与动力工程;水能、水力机械;水轮机;小型水轮机;	地质、矿产普查与勘探;钻探工程;钻头、钻具及工具;钻头;
机械工程;工程元件或部件;传送旋转运动的联轴器;离合器;联轴器;	机械、仪表工业;机械零件及传动装置;转动机件;联轴器、离合器;	工业技术;冶金工业;炼铁;炼铁产品;铸造生铁;球墨铸铁;
机械工程;工程元件或部件;转动工程元件;轴承;旋转运动的轴承;滑动接触轴承;	机械、仪表工业;机械零件及传动装置;转动机件;轴承;滑动轴承;塑料滑动轴承;	建筑科学;建筑材料;有机材料、建筑化工材料;建筑塑料及其制品;建筑塑料制品;门、窗等塑料配件和零件;
机械工程;工程元件或部件;转动工程元件;轴承;旋转运动的轴承;滚珠轴承;	机械、仪表工业;机械零件及传动装置;转动机件;轴承;滚动轴承;滚珠轴承;	无线电电子学、电信技术;基本电子电路;放大技术、放大器;放大器;
机械工程;工程元件或部件;转动工程元件;轴承;旋转运动的轴承;滚柱轴承;	机械、仪表工业;机械零件及传动装置;转动机件;轴承;滚动轴承;滚柱轴承;	太阳能技术;太阳能转换装置和设备;聚光器;
机械工程;一般机器或发动机;蒸汽机;非变容式机器或发动机，如汽轮机;	工业技术;能源与动力工程;蒸汽动力工程;蒸汽轮机;各种类型的蒸汽轮机;	工业技术;无线电电子学、电信技术;真空电子技术;电子管;复合管;
燃烧发动机的起动;发动机的起动辅助装置;发动机用电动机起动;	航空发动机;发动机附件系统;起动系统;原理;电动起动;	轻工业、手工业;造纸工业;机械与设备;造纸机械;长网造纸机;
机械工程;燃烧发动机的起动;发动机的起动辅助装置;发动机用电动机起动;	汽车工程;汽车发动机;往复式发动机;部件、零件;起动系统;电力起动;	农业工程;农业机械及农具;种植机械;播种机;特殊结构播种机;
机械工程;非变容式泵;离心泵;螺旋离心泵;离心泵;	工业技术;机械、仪表工业;泵;叶片式泵;离心泵;	航空设备、飞行控制与导航;防护设备及其技术;防护设备;防撞击设备;
机械工程;工程元件或部件;传动装置;用联轴器或离合器传送旋转运动的流体传动装置组合;	工业技术;机械、仪表工业;机械零件及传动装置;转动机件;联轴器、离合器;	无线电电子学、电信技术;雷达;雷达：按体制分;光学定位雷达、激光雷达;
机械工程;燃烧发动机;内燃机点火;电火花点火控制器;	能源与动力工程;内燃机;汽油机;构造;点火系统;	农业科学;农业工程;农业机械及农具;耕耘机具;犁;
加热;供热;住宅供热系统或区域供热系统;住宅或区域供热系统;	房屋建筑设备;空气调节、采暖及其设备;供热;供热系统和供热设备;	金属学与金属工艺;刀具、磨料、磨具、夹具、模具和手工具;磨具、研具;砂轮;
武器;弹药;弹药引信;引信的零部件;雷管;	武器工业;弹药、引信;火工品;引信雷管;电雷管;	轻工业、手工业;造纸工业;机械与设备;造纸机械;长网造纸机;
机械工程;蒸汽的发生;蒸汽锅炉;蒸汽锅炉的组成件或零部件;	能源与动力工程;蒸汽动力工程;蒸汽锅炉;锅炉构造;构件;	能源与动力工程;内燃机;汽油机;构造;点火系统;
干燥;对材料或制品进行干燥的机器或设备;	化学工业;感光材料工业;机械与设备;干燥设备;	电气化铁路;牵引变电所、变电设备;变电所一次设备;母线;
核物理;核工程;核发电厂;核发电厂的控制;安全装置;	电工技术;发电、发电厂;发电厂;核电厂（核电站）;环境与安全;	工业技术;无线电电子学、电信技术;真空电子技术;电子管;复合管;
计算;推算;计数;电数字数据处理;数据库结构;结构化数据，例如关系型数据;	自动化技术、计算机技术;计算技术、计算机技术;计算机的应用;各种专用数据库;	工业技术;金属压力加工;锻造用机械与设备;摩擦压力机;
计算;推算;计数;一切计算均用机械方式实现的数字计算机;计算器具，袖珍加法器;	自动化技术;计算技术、计算机技术;一般计算器和计算机;电子计算器;袖珍计算器;	轻工业、手工业;印刷工业;一般性问题;机械与设备;排版设备;
测量;测量距离、水准或者方位;罗盘;导航或测绘用的确定真北或磁北的装置;天文罗盘;	航空;航空仪表、航空设备、飞行控制与导航;导航仪表及传感器;航向仪表;天文罗盘;	工业技术;矿业工程;矿山安全与劳动保护;矿井通风;通风管理与通风构筑物;
计算;推算;计数;电数字数据处理;软件工程设计;软件设计;	自动化技术;计算技术、计算机技术;程序设计、软件工程;软件工程;	金属学;磨料、磨具;磨料;其他磨料;
核工程;核反应堆;反应堆燃料元件及其组装;用作反应堆燃料元件的材料的选择;刚性结构的许多燃料元件的组装;	原子能技术;核反应堆工程;反应堆部件及其设计、制造;燃料元件和组件;结构及设计;	化学工业;化学纤维工业;无机纤维;矿物纤维;石棉纤维;
利用了光波以外其他波的类似技术的装置或设备;利用光波以外的波获得记录;这类记录利用光学装置的显像;利用X射线;	无线电电子学、电信技术;真空电子技术;电子束器件、X射线管、阴极射线管;显示器件;电视显像管;	工业技术;轻工业、手工业;印刷工业;特种印刷;特种印刷：按油墨分;
核物理;核工程;核爆炸;其应用;核爆炸装置;	工业技术;原子能技术;核爆炸;	化学工业;试剂与纯化学品的生产;离子交换剂;离子交换剂的使用方法;电解法;
测量;测量电变量;用于测量电功率或电流的时间积分的装置，例如电表;	电工技术;电气测量技术及仪器;电数量的测量及仪表;电能测量、电度表;	植物学;植物分类学（系统植物学）;被子植物亚门;龙胆科;
信息存储;静态存储器;可擦除可编程序只读存储器;	自动化技术;计算技术、计算机技术;电子数字计算机;外部设备;外存储器;	纺织工业、染整工业;针织;针织用机具;手套机;
乐器;声学;手风琴或六角手风琴;手风琴、六角手风琴或类似乐器;	音乐;器乐理论与演奏法;键盘、簧乐理论和演奏法;手风琴;	化学;有机化学;脂肪族含氮化合物;氰酸及异氰酸的有机衍生物;
计算;推算;计数;一般的图像数据处理或产生;图像编码;	无线电电子学、电信技术;通信;图像通信、多媒体通信;图像编码;	工业技术;电工技术;独立电源技术（直接发电）;蓄电池;碱性蓄电池;
计算;计数;数据处理系统或方法;行政;管理;办公自动化，例如电子邮件或群件的计算机辅助管理;	自动化技术、计算机技术;计算技术、计算机技术;计算机软件;程序包（应用软件）;办公自动化系统;	交通运输;公路运输;桥涵工程;桥梁构造;墩台结构（下部结构）;桥台;
信号装置;信号装置或呼叫装置;指令发信装置;报警装置;把报警情况从中心台发信号给多个分台的报警系统;	自动化技术、计算机技术;自动化技术及设备;自动化系统;监视、报警、故障诊断系统;	建筑科学;市政工程;给水工程（上水道工程）;工业企业给水;给水系统;
测量;测量距离、水准或者方位;高程测量;通过使用气压计量装置;	测绘学;普通测量学、地形测量学;高程测量;气压高程测量;	金属腐蚀与保护、金属表面处理;金属表面防护技术;金属覆层保护;喷镀法;
物理;测量;红外光、可见光、紫外光的光谱成分;光度测定法;	物理学;光学;光辐射、光度学、色度学;光度学（测光学）;	工业技术;机械、仪表工业;机械零件及传动装置;转动机件;联轴器、离合器;
测量;温度测量;热量测量;温度计的测试或校准;	机械、仪表工业;仪器、仪表;热工量的测量仪表;温度测量仪表;	无线电电子学、电信技术;电视;电视：按体制分;彩色电视;
核物理;核工程;核反应堆;反应堆类型;热反应堆;	工业技术;原子能技术;受控热核反应;热核反应堆;	一般工业技术;工业通用技术与设备;爆破技术;
物理;测量;组中所列的及以采用光学测量方法为其特征的仪器;干涉仪;	天文学;天文观测设备与观测资料;天文仪器;天体物理仪器;干涉仪;	电子元件、组件;微波过渡元件;换向开关;同轴换向开关;
计算;计数;一切计算均用机械方式实现的数字计算机;计算机构及其执行装置;二进制的运算;	计算机技术;计算技术、计算机技术;电子模拟计算机;运算放大器和控制器;运算器;	冶金工业;冶炼原料及矿石预处理;矿石预处理、烧结;
物理;机器或结构部件的静或动平衡的测试;流体动力学试验;	数理科学和化学;力学;流体力学;普通流体力学;流体动力学;	化学;物理化学（理论化学）、化学物理学;表面现象的物理化学;吸附;吸附理论;离子交换吸附作用;离子交换剂;
摄影术;摄影用的装置或设备;立体摄影术;	一般工业技术;摄影技术;各种摄影技术;立体摄影;	机械、仪表工业;机械零件及传动装置;机械传动机构;啮合传动;凸轮;
摄影术;摄影、放映或观看用的装置或设备;立体摄影术;	摄影技术;摄影机具与设备;摄影设备;摄影机;立体摄影机;	农业机械及农具;田间管理机械;肥料机械;肥料施肥机具;
物理;测量;辐射的测量;辐射强度测量;	物理学;等离子体物理学;辐射与测量;	水利工程;水工材料;水泥、掺加料和外加剂;水泥;灌浆水泥;
物理;测量;核辐射或X射线辐射的测量;辐射的测量;剂量计;化学剂量计;	原子能技术;辐射探测技术;辐射探测技术;辐射剂量计;化学剂量计和生物剂量计;	动物医学;动物医学（兽医学）;家畜卫生及防疫;兽医卫生保健组织;兽医器材及药品管理;
物理;辐射的测量;测量截面，例如，测量粒子的吸收截面;	物理学;原子核物理学;中子物理;中子截面;吸收截面;	公路运输;汽车工程;汽车结构部件;电气设备及附件;点火系统;火花塞;
物理;光学;光学元件、系统或仪器;聚光镜;	太阳能技术;太阳能转换装置和设备;聚光器;	各种桥梁;桥梁：按结构分;拱式桥;桁架拱桥;
物理;借助于测定材料的化学或物理性质来测试或分析材料;利用超声波、声波来分析材料;	数理科学和化学;化学;分析化学;仪器分析法（物理及物理化学分析法）;超声波分析法;	农业科学;农学（农艺学）;农产品收获;收获;
乐器;电声乐器;其中由机电装置产生音调的乐器;应用机电驱动的带有拾音器的振动器的;	工业技术;轻工业、手工业;其他轻工业、手工业;乐器制造工业;电乐器;电振荡乐器;	食品工业;乳品加工工业;乳品加工工艺;乳制品加工;
声学;语音分析或合成;语音或声音处理;语音合成;	电声技术和语音信号处理;语音信号处理;语音合成;	交通运输;铁路运输;机车工程;机车构造;制动装置;电控制动及装置;
无线电定向;无线电导航;激光雷达系统;专门适用于特定应用的激光雷达系统;	无线电电子学、电信技术;雷达;雷达：按体制分;光学定位雷达、激光雷达;	制鞋工业;制鞋工业;结构、部件及配件;鞋跟;
教育;教育或演示用具;手写或绘画教具;	教育;教育;学前教育、幼儿教育;教具;	建筑科学;建筑设计;房屋细部构造设计;屋顶（屋面）、屋檐;
仪器的零部件;仪器的结构零部件;指示元件;	机械、仪表工业;仪器、仪表;显示仪表;直接指示仪;	大气科学（气象学）;大气探测仪器及设备;湿度测定仪器;湿度计;
测量;称量;带有自动供料或卸料以称量成批材料的称量设备;	炼钢机械与生产自动化;炼钢生产自动化;炉料和钢水自动称量;	轻工业、手工业;纺织工业、染整工业;化学纤维纺织;机械与设备;纺纱设备;
测量;核辐射或X射线辐射的测量;中子辐射的测量;用闪烁探测器;	粒子探测技术、辐射探测技术;中子和其他辐射探测器;中子探测器;	工业技术;轻工业、手工业;印刷工业;特种印刷;特种印刷：按油墨分;
物理;测量;核辐射或X射线辐射的测量;中子辐射的测量;	数理科学和化学;物理学;等离子体物理学;辐射与测量;	金属学与金属工艺;金属切削加工及机床;磨削加工与磨床;磨削加工工艺;抛光;
物理;测量;气象学;气象学;用于指示大气湿度的装置;	大气科学（气象学）;大气探测仪器及设备;湿度测定仪器;湿度计;	铁路运输;铁路运输管理工程;调车工作;调车场及调车设备;
物理;测量;气象学;气象学;雨量计或沉积物计量器;	大气科学（气象学）;云和降水测定仪器;雨量器、雨量计、量雪尺;	航空、航天;航空;飞机构造与设计;机身、座舱;座舱盖、整流片、整流罩;
物理;测量;测试;气象学;气象学;	地球科学;大气科学（气象学）;应用气象学;	金属压力加工;锻造、锻压;锻造用机械与设备;自由锻水压机;
信号装置;信号装置或呼叫装置;指令发信装置;报警装置;报警器;	电气化、电能应用;家用电器及其他电器设备;其他电器;家用报警器;	化学工业;试剂与纯化学品的生产;表面活性剂;表面活性剂的应用;乳化剂、分散剂、增溶剂;
摄影术;照相用的感光材料;多色工艺的感光材料;	工业技术;一般工业技术;摄影技术;感光材料;	工业技术;轻工业、手工业;纺织工业、染整工业;染整工业;印花;印花方法;
核辐射或X射线辐射的测量;粒子的运动或轨迹的记录;粒子轨迹的处理或分析;闪烁室;	原子能技术;粒子探测技术、辐射探测技术与核仪器仪表;粒子径迹探测器;闪烁室;	金属学与金属工艺;金属切削加工及机床;磨削加工与磨床;磨床设计、制造与维修;结构;机械结构;
核辐射或X射线辐射的测量;粒子的运动或轨迹的记录;粒子轨迹的处理或分析;气泡室;	原子能技术;粒子探测技术、辐射探测技术与核仪器仪表;粒子径迹探测器;气泡室;	化学工业;胶粘剂工业;动物胶;明胶;
物理;测量;导航;导航;导航仪器;专用于宇宙航行的导航;	无线电电子学;无线电导航;导航系统;宇宙飞行器导航系统;	建筑科学;建筑施工;各项工程与工种;模板工程;各种模板;
物理;测量;导航;导航;导航仪器;执行导航计算的仪器;	无线电电子学;无线电导航;导航设备、导航台;导航计算机;	化学;无机化学;化学元素与无机化合物;氧化物、过氧化物;
测量;长度的计量;计量设备;用于计量长度;	一般工业技术;计量学;几何量计量;长度计量;	汽车工程;汽车发动机;往复式发动机;各种类型往复式发动机;气体燃料发动机;
测量;线速度或角速度、加速度、减速度的测量;测量速度的平均值;	工业技术;一般工业技术;计量学;力学计量;速度与加速度计量;	机械、仪表工业;机械零件及传动装置;机械传动机构;摩擦传动;摩擦分合装置;
基于记录载体的信息存储;按所用记录载体的形状区分的;记录载体;	化学工业;磁性记录材料工业;原材料及辅助物料;载体;	冶金工业;冶炼原料及矿石预处理;矿石;
仪器的结构零部件;条或板的合成物，双金属片;	电工技术;电器;一般性问题;结构;双金属片;	工业技术;建筑科学;房屋建筑设备;机电设备;电梯工程;
物理;测量;机械振动的测量;检测器测量振动;	数理科学和化学;力学;振动理论;振动测量技术;	农业科学;植物保护;农药防治（化学防治）;各种农药;除草剂（杀草剂）;
物理;测量;地球物理;物质或物体的探测;地震学;	地球物理学;固体地球物理学;地震学;理论与方法;物理地震学;	机械、仪表工业;机械零件及传动装置;转动机件;轴承;
物理;测量;地球物理;物质或物体的探测;地震学;地震的勘探或探测;地震数据的处理;	地球科学;地球物理学;固体地球物理学;地震学;测震学;地震观测结果的解释与处理;	轻工业、手工业;制鞋工业;制鞋工业;制鞋机具与设备;其他;
测量;长度的计量;计量设备;用于计量长度;	仪表工业;仪器、仪表;计量仪器;长度计量仪器;	农业科学;农作物;饮料作物;咖啡;
教育或演示用具;模型;天象仪;地图;天象仪;	天文学;天文观测设备与观测资料;天文仪器;天象仪;	自动化技术及设备;机器人技术;机械手;专用机械手;
摄影术;摄影、放映或观看用的装置或设备;印片设备;	摄影技术;摄影机具与设备;洗印设备;洗印设备;印片机;	无线电电子学、电信技术;电视;电视设备;电视节目制作设备;摄像机;
核物理;核工程;核反应堆;慢化剂或堆芯结构;用作慢化剂材料的选择;	原子能技术;核反应堆工程;反应堆材料及其性能;慢化剂和反射层材料;	轻工业、手工业;造纸工业;制浆工艺;制浆法;化学制浆;
物理;控制;调节;调节电变量或磁变量的系统;调节电压或电流;	电工技术;输配电工程、电力网及电力系统;负荷分析;电压调整;	测绘学;普通测量学、地形测量学;高程测量;气压高程测量;
乐器;声学;带有一个或更多键盘的弦乐器;类似的弦乐器;	其他轻工业、手工业;乐器制造工业;西乐器;弓弦乐器;	测绘学;摄影测量学与测绘遥感;非地形摄影测量;近影摄影测量;
信号装置;信号装置或呼叫装置;指令发信装置;报警装置;夜盗、偷窃或入侵者报警器;	电工技术;电气化、电能应用;家用电器及其他电器设备;其他电器;家用报警器;	工业技术;化学工业;炼焦化学工业;煤的高温干馏;炼焦;炼焦过程;
测试;机器或结构部件的静或动平衡的测试;机械部件的测试;齿轮;传动机构;齿轮;	机械、仪表工业;机械零件及传动装置;机械传动机构;啮合传动;齿轮及齿轮传动;	化学工业;油脂和蜡的化学加工工业;油脂工业产品及副产品;副产品加工及利用;蜡;
产生用作定时标准的预选的时间间隔的仪器;应用带机电谐振器的振荡器;应用压电谐振器;	无线电电子学、电信技术;基本电子电路;振荡技术、振荡器;振荡技术;谐振;	农业工程;农业机械及农具;收获机械;分段收获机;割捆机;
测量;摄影测量学或视频测量学;立体摄影测量学;摄影测量术;	测绘学;摄影测量学与测绘遥感;非地形摄影测量;近影摄影测量;	化学工业;染料及中间体工业;各种结构的合成染料;靛系染料;
测量;摄影测量学或视频测量学;立体摄影测量学;摄影测量术;	建筑科学;建筑勘测;建筑工程测量及制图;摄影测量;	机械、仪表工业;机械零件及传动装置;机械传动机构;啮合传动;齿轮及齿轮传动;
教育或演示用具;模型;天象仪;地图;天象仪;	机械、仪表工业;仪器、仪表;天文仪器;天象仪;	金属学与金属工艺;焊接、金属切割;焊接工艺;金属材料的焊接;铝;
教育或演示用具;模型;地球仪;地图;地球仪;地球仪;	地球科学;测绘学;地图制图学（地图学）;地图模型、地球仪;	建筑科学;建筑设计;房屋细部构造设计;楼梯、坡道、电梯;
驱动机构;用气体驱动的;机械控制子钟的气体驱动装置;	往复式发动机;部件、零件;配气机构;气门及驱动机构;	金属压力加工;锻造、锻压;锻造用机械与设备;自由锻水压机;
乐器;声学;带有一个或更多键盘的弦乐器;类似的弦乐器;	其他轻工业、手工业;乐器制造工业;中国民族乐器;弓弦乐器;	自动化技术;计算技术、计算机技术;程序设计、软件工程;软件工程;
机器或结构部件的静或动平衡的测试;机械部件的测试;轴承;	机械、仪表工业;机械零件及传动装置;转动机件;轴承;	航空发动机制造;装配;装配工夹具;
摄影术;摄影、放映或观看用的装置或设备;影的特殊操作;所用的设备;	一般工业技术;摄影技术;摄影机具与设备;摄影设备;特技摄影装置;	武器工业;弹药、引信、火工品;弹药;炸弹;练习炸弹、试验炸弹;
摄影术;摄影、放映或观看用的装置或设备;照相机零部件或照相机的机身;机身;	一般工业技术;摄影技术;摄影机具与设备;照相设备与复制设备;照相机;	水利工程;水利枢纽、水工建筑物;取水、引水工程;泵站;
乐器;声学;弦乐器;管乐器;弦乐器的一般设计;	其他轻工业、手工业;乐器制造工业;西乐器;弓弦乐器;	能源与动力工程;蒸汽动力工程;蒸汽锅炉;锅炉构造;水处理及给水装置;
调节;非电变量的控制或调节系统;机械振荡的控制;	基本电子电路;振荡技术、振荡器;振荡器;机械振荡器;	铁路运输;机车工程;电力机车;牵引电动机;直流牵引电动机;
物理;测量;测试;测量电变量;测量磁变量;电功率、功率因数的测量装置;	电气测量技术及仪器;电数量的测量及仪表;功率测量及仪器;功率因数测量、功率因数表;	机械、仪表工业;机械零件及传动装置;机械传动机构;啮合传动;凸轮;
信号装置;交通控制系统;飞行器的交通控制系统;防撞系统;	航空设备、飞行控制与导航;防护设备及其技术;防护设备;防撞击设备;	农业科学;畜牧;普通畜牧学;畜牧业的机具及设备;
物理;光学;光学元件、系统或仪器;显微镜;	机械、仪表工业;仪器、仪表;光学仪器;显微镜;	烟草工业;烟草加工工艺及制品;雪茄烟;
地球物理;重力测量;物质或物体的探测;测量引力场或波;重力勘探或探测;用悬摆;	地球科学;地质、矿产普查与勘探;地球物理勘探;重力勘探;方法;振摆测量;	矿业工程;矿山设计与建设;凿岩爆破工程;掏槽方法;
计算;计数;数字计算机;辅助功能装置;操作次数计数装置;	机械、仪表工业;坐标器、计算机具、计数器;计数器;	农业工程;农业机械及农具;种植机械;播种机;特殊结构播种机;
乐器;打击乐器;其他类目中不包括的乐器;打击乐器;	其他轻工业、手工业;乐器制造工业;西乐器;打击乐器;	矿业工程;矿山机械;矿山固定机械设备;矿山排水设备;
乐器;打击乐器;其他类目中不包括的乐器;打击乐器;	其他轻工业、手工业;乐器制造工业;中国民族乐器;打击乐器;	无线电电子学、电信技术;基本电子电路;放大技术、放大器;放大器;
乐器;声学;打击乐器;零部件或附件;鼓;手鼓;	音乐;器乐理论与演奏法;打击乐理论和演奏法;小鼓、大鼓;	音乐;器乐理论与演奏法;键盘、簧乐理论和演奏法;风琴、管风琴;
物理;光学;眼镜;应用跨梁或眉杆的透镜组件的眼镜;	其他轻工业、手工业;眼镜及其制造;普通眼镜;	粒子探测技术、辐射探测技术;中子和其他辐射探测器;中子探测器;
物理;测量;红外光、可见光、紫外光的光谱成分;分光光度测定法;	天文学;太阳系;太阳物理学;太阳光谱;分光光度测量;	工业技术;机械、仪表工业;机械零件及传动装置;转动机件;联轴器、离合器;
信号装置;测量值、控制信号或类似信号的传输系统;相对于预定参照系的目标位置传送系统;	无线电电子学、电信技术;电视信号的传输;电视信号的光波传送系统、光放大器传输系统;	化学;有机化学;杂环化合物;含单异原子的六节杂环;
信号装置;信号装置或呼叫装置;指令发信装置;报警装置;信号装置;	公路运输;汽车工程;电气设备及附件;照明与信号系统;停刹车信号装置;	化学;无机化学;非金属元素及其化合物;零族元素、惰性气体;
物理;测量;光的偏振的测量;测量光的偏振;	物理学;光学;物理光学（波动光学）;偏振与色散;	一般工业技术;摄影技术;摄影机具与设备;摄影设备;特技摄影装置;
核物理;核工程;聚变反应堆;热核聚变反应堆;	原子能技术;各种核反应堆;裂变、聚变混合反应堆;	造纸工业;机械与设备;辅助设备器材;刀片;
测量;流量、质量流量的测量;测量相对于另一变量的流量;	能源与动力工程;热工量测;量测技术及仪表;流量量测;	服装工业、制鞋工业;制鞋工业;结构、部件及配件;鞋底、内底;
物理;摄影术;摄影用的装置或设备;专门适用于摄影用途的滤光器;	一般工业技术;摄影技术;摄影机具与设备;光学镜头、滤光器;滤光器;	电气化、电能应用;家用电器及其他电器设备;其他电器;家用报警器;
物理;摄影术;摄影用的装置或设备;照相机聚焦的辅助装置;照相机的聚焦装置;	一般工业技术;摄影技术;摄影机具与设备;照相设备与复制设备;照相机;	工业技术;电工技术;电器;继电器;电继电器;电磁继电器;
乐器;管风琴;管风琴或具有吹风设备的风乐器;风琴的，即管风琴;	音乐;器乐理论与演奏法;键盘、簧乐理论和演奏法;风琴、管风琴;	植物学;植物分类学（系统植物学）;被子植物亚门;伞形花目;伞形科;
计算;推算;计数;一切计算均用机械方式实现的数字计算机;存储机构;	计算机技术;计算技术、计算机技术;电子数字计算机;外部设备;外存储器;	医药、卫生;外科学;外科诊疗器械与用具;
物理;核物理;核工程;核发电厂;核发电厂的部件;	原子能技术;各种核反应堆、核电厂;核电厂（核电站）;	工业技术;化学工业;化学肥料工业;其他无机肥料;
核物理;核工程;处理放射性污染材料;及其去污染装置;处理固体的;固体废物的处置;	原子能技术;放射性废物管理及综合利用;放射性废物及其处理;固体放射性废物与处理;	食品工业;屠宰及肉类加工工业;肉类食品加工厂、屠宰场;
广告;显示;广告;活动的目视广告;	商品流通与市场;广告;广告策划与制作;	农业科学;水产、渔业;水产养殖技术;各种鱼类养殖;淡水鱼;青鱼;
物理;光学;光学系统或仪器;除透镜外的光学元件;棱镜;	无线电电子学;电视;电视光学;摄像光学系统;分光棱镜;	其他轻工业、手工业;体育器具制造工业;其他体育器具;登山运动器具;
计算;计数;模拟计算机;用于执行计算操作的装置，例如，为执行计算操作专用的放大器;	计算机技术;计算技术、计算机技术;电子模拟计算机;运算放大器和控制器;运算放大器;	工业技术;机械、仪表工业;机械零件及传动装置;转动机件;连杆、曲柄;
计算;计数;电数字数据处理;通用数字计算机;	计算机技术;电子数字计算机;各种电子数字计算机;	工业技术;电工技术;电工材料;超导体、超导体材料;
测量;温度测量;热量测量;以材料的膨胀或收缩为基础的温度测量仪表;	机械、仪表工业;仪器、仪表;热工量的测量仪表;温度测量仪表;	矿业工程;矿山机械;矿山固定机械设备;矿山排水设备;
测量;测量力或流体压力;测量压力的设备或仪表;	仪表工业;仪器、仪表;热工量的测量仪表;压力仪表;	文化、科学、教育、体育;球类运动;高尔夫球;
测量;勘测;专门用于露天水源勘测;	给水工程;取水工程;水源;水源勘测;	武器工业;弹药、引信、火工品;引信;武器用引信;水中兵器引信;
声学;语音识别;语音或声音处理;语音识别;	电声技术和语音信号处理;语音信号处理;语音识别;	铸造;铸造机械设备;熔炼设备;反射炉;
声学;语音或声音处理;处理语音或声音信号;语音增强;	通信;电声技术和语音信号处理;语音信号处理;语音增强;	造纸工业;制浆工艺;各种纸浆;蔗渣浆;
电学;基本电气元件;白炽灯;零部件;发光体;	电工技术;电气化、电能应用;电气照明;灯泡、灯管;白热灯泡、白炽灯;	电工技术;电气测量技术及仪器;电数量的测量及仪表;电能测量、电度表;
电学;电通信技术;图像通信，如电视;电视系统的零部件;同步;	无线电电子学、电信技术;电视;电视同步系统;多节目源电视系统的同步;	矿业工程;矿山设计与建设;凿岩爆破工程;掏槽方法;
电学;基本电子电路;放大器;磁放大器;电流控制的，即负荷电流双方向流过主线圈;	无线电电子学、电信技术;基本电子电路;放大技术、放大器;放大器;放大器：按工作原理分;	机械、仪表工业;机械零件及传动装置;转动机件;联轴器、离合器;
电学;基本电子电路;电子振荡器或脉冲发生器的自动控制、起振、同步或稳定;发生器的起振;	无线电电子学、电信技术;基本电子电路;脉冲技术、脉冲电路;脉冲的产生、脉冲发生器;间歇振荡器;	能源与动力工程;蒸汽动力工程;蒸汽锅炉;锅炉构造;构件;
电学;电通信技术;图像通信，如电视;电视系统;闭路电视系统;	无线电电子学、电信技术;电视;电视信号的传输;闭路电视系统;	工业技术;化学工业;炼焦化学工业;煤的高温干馏;炼焦;炼焦炉;
基本电气元件;用于直接转变化学能为电能的方法或装置;二次电池;碱蓄电池;	工业技术;电工技术;独立电源技术（直接发电）;蓄电池;碱性蓄电池;	金属学与金属工艺;焊接、金属切割;焊接工艺;金属材料的焊接;钢;
电学;电通信技术;数字信息的传输，例如电报通信;数据交换网络;分组交换系统;	无线电电子学、电信技术;通信;数据通信;各种数据传输系统;数据交换系统;	工业技术;机械、仪表工业;泵;容积泵;隔膜泵;
电学;电通信技术;无线通信网络;网络规划;网络配置;	无线电电子学、电信技术;通信;通信网;一般性问题;网络管理;	石油机械设备与自动化;钻井机械设备;钻头、钻具与工具;
电学;基本电气元件;继电器;选择器;电磁继电器的零部件;	工业技术;电工技术;电器;继电器;电继电器;电磁继电器;	航空;航空发动机;发动机附件系统;冷却系统;空气喷气发动机冷却系统;
电动机;用于调节或控制直流电动机的速度或转矩的装置;用于控制直流电动机的旋转方向;	铁路运输;机车工程;电力机车;牵引电动机;直流牵引电动机;	电工技术;电器;电容器;电容器:按结构分;固定式电容器;
基本电气元件;磁体;电感;磁性材料的选择;超导磁体;超导线圈;	工业技术;电工技术;电工材料;超导体、超导体材料;超导磁铁;	建筑科学;建筑材料;防水、防潮材料，嵌缝、密封材料;油毡、防水卷材;油毛毡、油毡纸;
电机;有机械换向器的直流换向器电动机或发电机;通用交直流换向器电动机;以励磁装置为特征的;	工业技术;电工技术;电机;直流电机;励磁直流电机;串励直流电机;	电声技术和语音信号处理;语音信号处理;语音合成;
基本电子电路;脉冲技术;脉冲计数器或分频器的零部件;计数器的启动、停止或复位;	工业技术;机械、仪表工业;仪器、仪表;坐标器、计算机具、计数器;计数器;	轻工业、手工业;烟草工业;烟草加工工艺及制品;卷烟制造;切丝、烘丝;
电学;发电、变电或配电;电机;直流断续电动机;	工业技术;电工技术;电机;电动机（总论）;	能源与动力工程;特殊热能及其机械;太阳能技术;太阳能转换装置和设备;聚光器;
电学;发电、变电或配电;电机;发电机;	电工技术;电机;发电机、大型发电机组（总论）;	金属学与金属工艺;金属压力加工;轧制;轧钢机械设备;轧机主列机构和设备;轧辊及轧辊轴承;
电学;基本电子电路;一般编码、译码或代码转换;增量调制，即单比特差分调制;	无线电电子学、电信技术;基本电子电路;调制技术与调制器;增量调制;	电工技术;电器;电感器、线圈、扼流圈;固定电感线圈;
电学;基本电气元件;电开关;由可绕其纵向轴旋转的开关;	电工技术;电器;开关电器、断路器;各种开关;旋转和滑动开关;	航空发动机制造;装配;装配工夹具;
电学;电通信技术;图像通信，如电视;彩色电视系统的零部件;	无线电电子学、电信技术;电视;电视：按体制分;彩色电视;	地球科学;大气科学（气象学）;应用气象学;
电学;基本电气元件;波导;传输线或其他波导型器件;波导型延迟线;交指型传输线;	无线电设备;馈线设备（传输线和波导）;波导、波导管、波导传输线;各种结构形式的波导;	电工技术;电器;继电器;电继电器;电磁继电器;
电学;基本电气元件;放电管或放电灯;电子管;	无线电电子学;真空电子技术;电子管;二极管;	铁路运输;铁路线路工程;铁路养护与维修;除雪、防雪、防冰冻及设备;
电学;基本电子电路;谐振电路;谐振器;机电谐振器;滤波器;	无线电电子学;基本电子电路;滤波技术、滤波器;谐振体;	无线电电子学、电信技术;电视;电视信号的传输;闭路电视系统;
电学;基本电子电路;阻抗网络;移相器;	无线电电子学;电子元件、组件;移相器、铁氧体移相器;	农业科学;农业基础科学;肥料学;农家肥料;人粪尿;
电学;基本电气元件;磁体;磁性材料的选择;磁体;永久磁体;	电工技术;电工材料;磁性材料、铁氧体;永磁材料、永久磁铁;	电工技术;电气化、电能应用;家用电器及其他电器设备;其他电器;家用报警器;
电学;基本电气元件;磁体;磁性材料的选择;磁体;电磁铁;	电工技术;电器;一般性问题;结构;电磁结构（电磁铁）;	电信技术;通信;通信保密与通信安全;保密通信:按传输线路分;无线保密通信;
电学;基本电气元件;磁体;磁性材料的选择;磁体;电磁铁;含有电磁铁的制动器;	电工技术;电器;控制器、接触器、起动器、电磁铁;电磁铁;制动电磁铁;	物理学;等离子体物理学;辐射与测量;
电学;基本电气元件;电容器;电解型的电容器;卷绕电容器;	电工技术;电器;电容器;电容器:按结构分;卷式电容器;	电工技术;电工材料;绝缘材料、电介质及其制品;绝缘子和套管;
电学;基本电气元件;电容器;电解型的电容器;固定电容器;	电工技术;电器;电容器;电容器:按结构分;固定式电容器;	医药、卫生;预防医学、卫生学;流行病学与防疫;消毒;光线消毒、紫外线消毒;
电学;基本电气元件;继电器;电磁继电器;	电工技术;电器;继电器;电继电器;电磁继电器;	玩具制造工业;各种玩具：按用途分;游艺性玩具;
电学;电通信技术;传声器、声—机电传感器;压电传感器;传声器;	电信技术;电子元件、组件;电声器件;传声器;电容式传声器;	航空、航天;航空;飞机构造与设计;机身、座舱;座舱盖、整流片、整流罩;
电学;基本电气元件;放电管或放电灯;真空管;放电通道的管;复合管;	工业技术;无线电电子学、电信技术;真空电子技术;电子管;复合管;	轻工业、手工业;造纸工业;制浆工艺;制浆法;化学制浆;
电学;电机;专用于制造电机的方法或设备;机壳;机罩;支承物;	电工技术;电机;一般性问题;电机结构及部件;机壳;机罩;机座;	电工技术;电器;继电器;电继电器;电磁继电器;
电学;电机;专用于制造电机的方法或设备;	电工技术;电机;电机制造工艺及设备;一般制造工艺;	工业技术;武器工业;火炮;迫击炮;
电学;基本电气元件;变压器;信号类型的固定变压器;声频变压器;	电工技术;变压器、变流器;变压器：按频率分;音频变压器、成声变压器;	冶金工业;有色金属冶炼;金属提炼;火法提炼;热还原法;铝热法;
电学;基本电气元件;电感;电感器;仪用互感器;用于单相交流的;电压互感器;	电工技术;变压器、变流器及电抗器;互感器;电压互感器;单相电压互感器;	电工技术;电器;开关电器、断路器;熔断器、保险丝装置;
电学;变电或配电;电机;有永久磁体的同步电动机;	工业技术;电工技术;电机;电动机（总论）;	机械、仪表工业;机械零件及传动装置;机械传动机构;啮合传动;凸轮;
电学;发电、变电或配电;电机;有永久磁体的同步发电机;	电工技术;电机;发电机、大型发电机组;永磁发电机;	无线电电子学、电信技术;无线电设备、电信设备;终端设备;
电学;电机;结构上与电机连接用于控制机械能的装置;平衡装置;	电工技术;电机;一般性问题;电机制造工艺及设备;电机的平衡;	工业技术;机械、仪表工业;泵;叶片式泵;离心泵;
电学;基本电气元件;电阻器;不可调电阻器;	电工技术;电器;电阻器、电位器;固定电阻器;	无线电电子学、电信技术;基本电子电路;脉冲变换、脉冲变换电路;脉冲限幅;
电学;电通信技术;传输;传输系统;非光传输系统;	电信技术;通信;数据通信;各种数据传输系统;数字数据传输系统;	金属学与金属工艺;金属表面处理;金属表面防护技术;金属复层保护;电镀法;
电学;电通信技术;传输;利用电磁波（例如红外线、可见光或紫外线）的传输系统;	无线电电子学、电信技术;电视;电视信号的传输;电视信号的红外线传输系统;	文教用品制造工业;绘图工具;绘图板、绘图桌;
电学;电通信技术;传输;利用无线电波以外的电磁波的传输系统;接收机;	无线电电子学;无线电设备;接收设备、无线电收音机;接收机：按形式分;	医药、卫生;药学;药剂学;剂型;片剂;
电学;电通信技术;传输;传输系统;中继器;	电信技术;通信;电报中继及交换;中继器;	往复式发动机;部件、零件;配气机构;气门及驱动机构;
电通信技术;无线通信网络;专门适用于无线通信网络的接口;	铁路通信;无线通信;铁路移动无线通信;列车无线通信及设备;接口;	轻工业、手工业;食品工业;乳品加工工业;各种乳制品;干酪;
基本电气元件;电开关;复合运动的开关;轴线方向进行的;	电子元件、组件;微波过渡元件;换向开关;同轴换向开关;	电工技术;电器;开关电器、断路器;熔断器、保险丝装置;
电学;电通信技术;助听器;助听器;	耳科学、耳疾病;病理听力学及助听器;	物理学;原子核物理学;中子物理;中子截面;吸收截面;
电通信技术;电视;电视系统的扫描部件;不是等速的，非水平线或垂直线形成图形的;	无线电电子学、电信技术;电视;电视扫描系统;非线性扫描系统;	电气化铁路;牵引变电所、变电设备;变电所一次设备;母线;
电学;电通信技术;无线通信网络;安全装置;保密或匿名;保密或匿名;	电信技术;通信;通信保密与通信安全;保密通信:按传输线路分;无线保密通信;	航空发动机制造;装配;装配工夹具;
电学;电通信技术;无线通信网络;安全装置，例如接入安全或欺诈检测;	无线电电子学、电信技术;通信;通信保密与通信安全;通信安全技术;	食品工业;制糖工业;各种糖的生产;麦芽糖;
电学;基本电子电路;放大的控制;放大器或变频器的增益控制;	无线电电子学、电信技术;基本电子电路;放大技术、放大器;放大器;	能源与动力工程;蒸汽动力工程;蒸汽锅炉;锅炉构造;构件;
电学;发电、变电或配电;电缆或电线的安装;电缆配件;	电工材料;导电材料及其制品;电气装备用电线电缆;通用电线电缆;	航空设备、飞行控制与导航;防护设备及其技术;防护设备;防撞击设备;
电学;电缆;按形状区分的电缆;海底电缆;	海洋学;海洋工程;海下工程;水下电缆;	数理科学和化学;化学;分析化学;仪器分析法（物理及物理化学分析法）;超声波分析法;
电学;发电、变电或配电;电机;永磁式的;	电工技术;电机;特殊电机;永磁电机;	无线电电子学;电视;电视光学;摄像光学系统;分光棱镜;
基本电气元件;继电器;应用电动力效应的继电器;永磁式继电器;	工业技术;电工技术;电器;继电器;电继电器;电磁继电器;	纺织工业、染整工业;毛纺织;原毛初加工;羊毛脂回收;
电学;基本电气元件;白炽灯;非一般照明用灯;用于探照灯的;	电工技术;电气化、电能应用;电气照明;照明器;探照灯;	工业技术;机械、仪表工业;仪器、仪表;坐标器、计算机具、计数器;计数器;
电学;基本电气元件;白炽灯;非一般照明用灯;用于指示的;	电工技术;电气化、电能应用;电气照明;照明器;指示灯;	轻工业、手工业;造纸工业;机械与设备;制浆机械;蒸煮设备;
电学;基本电子电路;阻抗网络，谐振器;N通道滤波器;	无线电电子学;基本电子电路;滤波技术、滤波器;谐振体;	公路运输;汽车工程;汽车结构部件;电气设备及附件;点火系统;火花塞;
电学;基本电气元件;半导体器件;专门适用于制造或处理这些半导体器件或其部件的方法或设备;	无线电电子学、电信技术;半导体技术;一般性问题;半导体器件制造工艺及设备;表面处理;	生物科学;生物化学;糖;二糖;蔗糖;
电学;电通信技术;无线通信网络;无线通信网络的设备;终端设备;	无线电电子学、电信技术;无线电设备、电信设备;终端设备;	轻工业、手工业;烟草工业;烟草加工工艺及制品;卷烟制造;切丝、烘丝;
电学;基本电气元件;谐振器;波导型谐振器;空腔谐振器;	无线电电子学;电子元件、组件;微波传输控制元件;空腔谐振器;	无线电电子学、电信技术;真空电子技术;气体放电器件;冷阴极气体放电管;
电学;基本电气元件;谐振器;波导型谐振器;空腔谐振器;	无线电设备、电信设备;传输线和波导;空腔谐振器、谐振腔;	机械、仪表工业;机械零件及传动装置;转动机件;联轴器;
电学;发电、变电或配电;变电站或开关装置;封闭式变电站，例如紧凑型变电站;	电工技术;变压器、变流器;电力变压器;油浸式电力变压器;成套变电站用变压器;	机械、仪表工业;机械零件及传动装置;转动机件;联轴器、离合器;
发电、变电或配电;电机;带有磁体、电枢或其他磁路部分的发电机;	电工技术;电机;发电机、大型发电机组（总论）;永磁发电机;	金属压力加工;锻造、锻压;锻造用机械与设备;锻炉及工具;锻炉;
电学;基本电子电路;放大的控制;限幅;限制幅度的变化率;限制幅度的变化率;	无线电电子学、电信技术;基本电子电路;脉冲变换、脉冲变换电路;脉冲限幅;	金属学与金属工艺;焊接、金属切割;焊接工艺;金属材料的焊接;铝;
发电、变电或配电;电缆或电线的安装;母线的安装;	电气化铁路;牵引变电所、变电设备;变电所一次设备;母线;	冶金工业;炼铁;高炉操作;开炉、配料;开炉、装料;
电学;基本电气元件;电感;信号类型的固定电感器;	电工技术;电器;电感器、线圈、扼流圈;固定电感线圈;	化学工业;化学纤维工业;无机纤维;玻璃纤维;
电学;基本电气元件;放电管或放电灯;有气体阴极的充气放电管，如等离子阴极;	无线电电子学、电信技术;真空电子技术;气体放电器件;冷阴极气体放电管;	电气化、电能应用;家用电器及其他电器设备;其他电器;家用报警器;
基本电气元件;天线;波导型喇叭或开口;漏波导天线;沿着导引波传输的途径辐射的等效结构;	无线电电子学、电信技术;电子元件、组件;微波传输控制元件;波导定向耦合器;	金属学与金属工艺;焊接、金属切割;焊接工艺;;金属材料的焊接;铸铁;
基本电气元件;天线;波导型喇叭或开口;漏波导天线;沿着导引波传输的途径辐射的等效结构;	无线电电子学、电信技术;传输线和波导;波导、波导管、波导传输线;	化学;分析化学;元素及化合物的分离方法;物相分析;超离心机法;
紧急保护装置;过电流动作并需单独复位动作的过负荷保护断路开关;	交通运输;铁路运输;机车工程;电力机车;保护装置;过负荷保护;	造纸工业;制浆工艺;各种纸浆;蔗渣浆;
电学;电通信技术;图像通信，如电视;静止视频摄像机;	无线电电子学、电信技术;电视;电视设备;电视节目制作设备;摄像机;	轻工业、手工业;纺织工业、染整工业;一般性问题;混纺织物;普通织物;
电学;基本电子电路;脉冲技术;基本上有有限斜率或阶梯的脉冲的产生;	无线电电子学;基本电子电路;脉冲技术、脉冲电路;脉冲的产生、脉冲发生器;	工业技术;金属学与金属工艺;焊接、金属切割及金属粘接;焊接工艺;堆焊及补焊;
电学;基本电气元件;利用除光之外的波范围内的电磁辐射的受激发射器件;半导体激光器;	无线电电子学;光电子技术、激光技术;激光技术、微波激射技术;激光器;半导体激光器;	工业技术;电工技术;电器;继电器;电继电器;电磁继电器;
电学;基本电气元件;半导体器件;不具有不同材料结点的热电器件;热磁器件;	无线电电子学、电信技术;半导体技术;半导体热电器件、热敏电阻;敏感器件;	无线电电子学;基本电子电路;振荡技术、振荡器;振荡器;
基本电气元件;电开关;继电器;无灭弧或防弧装置的高压空气断路器;	电工技术;电器;开关电器、断路器;断路器;空气断路器、压缩空气断路器;	化学工业;染料及中间体工业;各种性能的合成染料;碱性染料;
基本电气元件;绝缘体;导电、绝缘或介电材料的选择;绝缘子或绝缘物体;	电工技术;电工材料;绝缘材料、电介质及其制品;绝缘子和套管;	轻工业、手工业;制鞋工业;制鞋工业;制鞋机具与设备;其他;
电通信技术;扬声器、传声器、唱机拾音器或其他声机电传感器;立体声装置;	无线电电子学、电信技术;电子元件、组件;电声器件;扬声器;立体声扬声器;	其他轻工业、手工业;乐器制造工业;中国民族乐器;打击乐器;
基本电气元件;电开关;由物理状态的变化操作的开关;	电工技术;发电、发电厂;配电设备和电气接线;开关设备;	武器工业;弹药、引信;火工品;引信雷管;电雷管;
基本电子电路;放大器;只带有电子管或只带有半导体器件作为放大元件的放大器;	无线电电子学、电信技术;基本电子电路;放大技术、放大器;放大器;	汽车工程;汽车结构部件;电气设备及附件;照明与信号系统;停刹车信号装置;
基本电气元件;电开关;电流通过其可熔材料的部分，电流过大时，由可熔材料的熔断使电流中断的保护装置;	电工技术;电器;开关电器、断路器;熔断器、保险丝装置;限流熔断器;	纺织工业;混纺织物;纱线;纱或线;
基本电气元件;放电管或放电灯;放电管或灯的零部件;	真空电子技术;气体放电器件、离子管;脉冲放电管;火花放电管;	轻工业、手工业;纺织工业、染整工业;一般性问题;混纺织物;普通织物;
基本电气元件;电阻器;不可调电阻器;	电工技术;电器;电阻器、电位器;固定电阻器;	航空;基础理论及试验;空气动力学;飞机空气动力学;涵道风扇空气动力学;
发电、变电或配电;配电盘、变电站或开关装置;熔断器、电阻器或类似装置的设备;	电工技术;电器;开关电器、断路器;熔断器、保险丝装置;	机械、仪表工业;起重机械与运输机械;起重机械;简易起重机械;升降机、升降台;
发电、变电或配电;配电盘、变电站或开关装置;熔断器、电阻器或类似装置的设备;	电工技术;电器;开关电器、断路器;熔断器、保险丝装置;限流熔断器;	电气化、电能应用;家用电器及其他电器设备;其他电器;家用报警器;
基本电气元件;谐振器、传输线或其他波导型器件;专用于制造波导或谐振器;	无线电电子学、电信技术;电子元件、组件;微波传输控制元件;空腔谐振器;	轻工业、手工业;造纸工业;制浆工艺;各种纸浆;木浆;
电学;基本电气元件;放电管或放电灯;气体或蒸气放电灯;	电工技术;电气化、电能应用;电气照明;灯泡、灯管;气体放电灯;	化学工业;农药工业;杀菌剂;抗菌素;
电学;基本电气元件;白炽灯;一般照明用灯;	电气化、电能应用;电气照明;灯泡、灯管;白热灯泡、白炽灯;	冶金工业;炼钢;转炉炼钢;熔炼过程及操作;造渣;
电学;基本电气元件;放电管或放电灯;X射线管;X射线管;	无线电电子学、电信技术;真空电子技术;X射线管、阴极射线管;	数理科学和化学;化学;分析化学;仪器分析法（物理及物理化学分析法）;超声波分析法;
基本电气元件;导体;导电或介电材料的选择;超导或高导导体;	工业技术;电工技术;电工材料;超导体、超导体材料;	医药、卫生;外科学;外科手术学;绷带学;
电学;电机;传送或接收角位移的电机，例如自整角机;	电工技术;电机;微电机;控制用微电机;自整角机;	耳科学、耳疾病;病理听力学及助听器;
电学;基本电气元件;磁体;电感;线圈;	电器;电感器、线圈、扼流圈;磁芯电感线圈;	航空;基础理论及试验;空气动力学;飞机空气动力学;涵道风扇空气动力学;
电学;基本电子电路;脉冲技术;调制类型的转换，例如位置调制脉冲变为持续时间调制脉冲;	无线电电子学、电信技术;基本电子电路;脉冲技术、脉冲电路;脉冲调制、解调，脉冲调制器;	电声技术和语音信号处理;语音信号处理;语音合成;
电学;基本电子电路;脉冲技术;逻辑电路;	计算机技术;电子数字计算机;基本电路;逻辑电路;	工业技术;化学工业;合成树脂与塑料工业;聚合类树脂及塑料;聚醚类;聚硫醚;
电学;基本电子电路;脉冲技术;逻辑电路;	电信技术;基本电子电路;数字电路;逻辑电路;	农业科学;农业基础科学;肥料学;施肥机具;
电学;电技术;等离子体技术;回旋加速器;同步回旋加速器，即调频回旋加速器;	工业技术;原子能技术;加速器;循环加速器;回旋加速器;等时性回旋加速器;	冶金工业;炼钢;转炉炼钢;熔炼过程及操作;吹炼;
电学;电技术;等离子体技术;回旋加速器;同步加速器;	工业技术;原子能技术;加速器;循环加速器;同步加速器;	工业技术;原子能技术;核爆炸;
电学;基本电气元件;利用辐射【激光】受激发射使用光放大过程来放大或产生光的器件;激光器;结构零部件;	工业技术;无线电电子学、电信技术;光电子技术、激光技术;激光技术、微波激射技术;激光器结构;	化学工业;橡胶工业;胶乳制品;海绵类;
电学;基本电子电路;阻抗网络;使用有源元件的网络;	无线电电子学、电信技术;基本电子电路;网络;有源网络;	农业机械及农具;田间管理机械;肥料机械;肥料施肥机具;
电学;基本电气元件;变压器;固定变压器;自耦变压器;	变压器;电力变压器;油浸式电力变压器;自耦变压器;	化学;物理化学（理论化学）、化学物理学;化学动力学、催化作用;催化;催化剂;催化剂的种类;
电学;基本电子电路;脉冲技术;用连续可变调制信号调制脉冲的;幅度调制，即PAM;	基本电子电路;脉冲技术、脉冲电路;脉冲调制、解调，脉冲调制器;脉冲幅度调制;	纺织工业、染整工业;针织;针织用机具;准备机械;
电学;基本电子电路;阻抗网络;横向滤波器;	基本电子电路;滤波技术、滤波器;各形滤波器;	轻工业、手工业;纺织工业、染整工业;丝纺织;丝纺织物;
电学;电通信技术;保密通信;对通信的干扰;反干扰;	电信技术;电子对抗（干扰及抗干扰）;反干扰;抗干扰技术;	金属学与金属工艺;金属表面处理;金属表面防护技术;金属复层保护;电镀法;
电学;电通信技术;无线通信网络;安全装置，例如接入安全;接入安全;	无线电电子学、电信技术;通信;通信保密与通信安全;通信安全技术;	其他轻工业、手工业;玩具制造工业;各种玩具：按用途分;玩偶的服饰、用具;
电学;基本电气元件;天线;天线辅助设备或与天线结合的装置;	无线电电子学、电信技术;无线电设备、电信设备;天线;天线辅助设备;	公路运输;汽车工程;汽车结构部件;制动系统;制动器;鼓式;
电学;电通信技术;传声器;动圈、动片或动线型传感器;传声器;	无线电电子学、电信技术;电声器件;传声器;变阻式传声器;	交通运输;公路运输;汽车工程;整车设计与计算;整车性能计算;制动性计算;
电学;电通信技术;声—机电传感器;动圈、动片或动线型传感器;电话受话器;	无线电电子学、电信技术;电子元件、组件;电声器件;受话器;电动受话器;	水利工程;水利枢纽、水工建筑物;取水、引水工程;泵站;
